定义能帮人们降低工作难度或省力的工具	什么
类别机械	什么
定义以作物种子为播种对象的种植机械	什么
类别农业机械	什么
发明时间公元前1世纪	什么时候
种类谷物条播机	什么
种类玉米穴播机	什么
种类棉花播种机	什么
种类牧草撒播机	什么
定义用于牵引或驱动的动力设备	什么
种类轮式拖拉机	什么
种类履带式拖拉机	什么
种类船形拖拉机	什么
种类自走底盘拖拉机	什么
发明者塞勒斯·麦考密克	谁
类别人	什么
作用收割农作物	什么
定义一体化收割农作物的机械	什么
外文名harvester	什么
种类侧挂式收割机	什么
种类手扶式收割机	什么
定义指用于工程建设的施工机械的总称	什么
类别工程机械	什么
作用对货物进行装卸、堆垛	什么
作用短距离运输作业	什么
发明时间1920年	什么时候
种类内燃叉车	什么
种类电动叉车	什么
种类仓储叉车	什么
定义利用刀型或斗型切削装置在走行中铲掘、切削土石的机械装置	什么
作用铲掘切削	什么
作用运输土石方	什么
类别铲土运输机械	什么
工作原理前方装有大型的金属推土刀，使用时放下推土刀，向前铲削并推送泥、沙及石块等	什么
作用能单独完成挖土、运土和卸土工作	什么
作用铲装土壤、砂石、石灰、煤炭等散状物料	什么
作用对矿石、硬土等作轻度铲挖作业	什么
使用场景路基工程的填挖	什么
使用场景沥青混合料的集料	什么
使用场景水泥混凝土料场的集料	什么
使用场景装料	什么
定义利用刮刀平整地面的土方机械	什么
作用构筑路基和路面	什么
工作原理刮土板能在空间完成6度运动	什么
定义利用机械力使土壤、碎石等填层密实的土方机械	什么
作用用于地基、道路、飞机场、堤坝等工程	什么
定义利用机器取代人工把水泥、河沙、碎石、水按照一定的配合比进行搅拌，生产出建筑工程等生产作业活动所需的混凝土的机械设备	什么
作用搅拌混凝土	什么
外文名train	什么
作用铁路运输	什么
定义指在铁路轨道上行驶的车辆	什么
类别交通机械	什么
发明时间1804年	什么时候
发明者斯蒂芬孙	谁
别名铁路列车	什么
轨道类型有砟轨道	什么
轨道类型无砟轨道	什么
工作原理转向架卡在轨道上沿着轨道行驶，转弯时转向架转动，让火车沿着轨道继续行驶	什么
定义指轨下基础为石质散粒道床的轨道	什么
别名碎石道床轨道	什么
优点弹性良好	什么
优点价格低廉	什么
优点更换与维修方便	什么
优点吸噪特性好	什么
缺点容易变形	什么
缺点维修频繁	什么
定义指采用混凝土、沥青混合料等整体基础取代散粒碎石道床的轨道结构	什么
优点使用寿命长	什么
优点耐久性好	什么
优点维修工作少	什么
别名无碴轨道	什么
驱动方式以机械化螺旋浆推进	怎样
发明者富尔顿	谁
构成轮船	什么
优点不依靠风，比帆船快	什么
外文名ship	什么
作用海上运输	什么
构成主体部分	什么
构成上层建筑部分	什么
构成船壳	什么
构成上甲板围成的具有特定形关的空心体	什么
作用一般用于布置动力装置、装载货物、储存燃料和淡水，以及布置其他各种舱室	什么
作用主要用于布置各种用途的舱室	什么
定义指具有一具或多具发动机的动力装置产生前进的推力或拉力，由机身的固定机翼产生升力，在大气层内飞行的重于空气的航空器	什么
发明时间1903年12月17日	什么时候
发明者莱特兄弟	谁
主要制造商波音公司	谁
主要制造商洛克希德	谁
主要制造商联合航空制造公司	谁
主要制造商空中客车	谁
主要制造商达索	谁
主要制造商庞巴迪	谁
工作原理飞机的机翼横截面一般上表面拱起、下表面较平。当等质量空气同时通过机翼上表面和下表面时，会在机翼上下方形成不同流速，从而产生一个向上的升力。	什么
构成飞机	什么
作用空中运输	什么
作用主要用来装载人员、货物、燃油、武器和机载设备	什么
作用用来产生升力	什么
种类平直翼	什么
种类后掠翼	什么
种类三角翼	什么
构成尾翼	什么
安装位置机身尾部	哪里
作用保持飞机的方向平衡和操纵	什么
作用保持俯仰平衡和俯仰操纵	什么
作用使飞机在地面或水面进行起飞、着陆、滑行和停放	什么
作用从驾驶杆（盘）到水平尾翼、副翼、方向舵等操纵面，用来传递飞行员操纵指令，改变飞行状态	什么
作用用来产生拉力（螺旋桨飞机）或推力（喷气式飞机），使飞机前进	什么
外文名the boeing company	什么
国别美国	什么
总部地点美国芝加哥市	哪里
创立时间1916年7月15日	什么时候
创始人威廉·爱德华·波音	谁
经营民机制造	什么
经营军火制造	什么
经营空间开发	什么
2015年营业额961.14亿美元	多少
员工数超过17万	多少
驱动方式汽油机驱动	怎样
操作方式靠手把操纵前轮转向	怎样
特点轻便灵活，行驶迅速	什么
发明者戈特利伯·戴姆勒	谁
发明时间1885年	什么时候
发动机二冲程汽油机	什么
发动机四冲程汽油机	什么
知名品牌嘉陵摩托	什么
知名品牌钱江摩托	什么
知名品牌豪爵摩托	什么
类别品牌	什么
类别摩托车品牌	什么
外文名suzuki	什么
外文名bicycle	什么
别名脚踏车	什么
别名单车	什么
种类代步车	什么
种类山地车	什么
发明者西夫拉克	谁
发明时间1790年	什么时候
构成自行车	什么
类别自行车零件	什么
定义安装在连轮和飞轮上的链子	什么
作用将脚踏力由曲柄、链轮传递到飞轮和后轮上，带动自行车前进	什么
定义装配在中轴部件的左右曲柄上，是一个将平动力转化为转动力的装置	什么
定义一种自行车改造而成的三轮的交通工具，可以载人也可运货	什么
外文名tricycle	什么
发明时间20世纪30年代以后	什么时候
种类货车	什么
种类公交车	什么
种类轿车	什么
定义由动力驱动，具有4个或4个以上车轮的非轨道承载的车辆	什么
外文名vehicle	什么
外文名auto	什么
别名car	什么
作用代步	多少
作用运输	什么
发明者卡尔·佛里特立奇·奔驰	谁
驱动方式发动机	怎样
发明时间1886年	什么时候
外文名bus	什么
别名公共汽车	什么
别名巴士	什么
起源1826年	什么时候
类别汽车	什么
外文名truck	什么
定义一种主要为载运货物而设计和装备的商用车辆	什么
作用装载运输	什么
知名品牌福田欧曼	什么
知名品牌东风天龙	什么
知名品牌德龙	什么
工作原理发动机产生动力，并将动力传给变速箱，动力经过变速箱里的齿轮将高转速小力矩动力转化为低转速大力矩动力，再通过传动轴传到驱动后桥，驱动后桥带动驱动后轮转动	什么
构成货车	什么
定义驾驶室和后备厢做成同一个厢体	什么
优点放倒后座，行李厢容积扩增	什么
定义车身结构由三个相互封闭用途各异的“厢”所包含的车	什么
优点中间高两头低	什么
缺点车身尺寸较长	什么
造型有“屁股”	什么
代表车系奥迪avant	什么
代表车系奔驰旅行版	什么
代表车系宝马wagon	什么
特点有轿车的舒适	什么
特点有大的行李空间	什么
外文名wagon	什么
外文名suv	什么
全名sport utility vehicle	什么
中文名运动型多用途汽车	什么
特点强动力	什么
特点越野型	什么
特点宽敞舒适	什么
知名品牌凯迪拉克	什么
知名品牌哈弗	什么
知名品牌路虎	什么
外文名sportscar	什么
外文名sportycar	什么
造型低底盘、线条流畅、动力突出	什么
特点不断追求速度极限	什么
种类轿跑	什么
种类敞篷跑车	什么
种类双门跑车	什么
知名品牌法拉利	什么
知名品牌玛莎拉蒂	什么
知名品牌兰博基尼	什么
外文名bavarian motor work	什么
外文名bayerische motoren werke ag	什么
创立时间1916年3月7日	什么时候
创始人吉斯坦·奥托	谁
主要生产汽车	什么
所属行业车辆制造	什么
总部地点德国巴伐利亚州慕尼黑	哪里
国别德国	什么
经营高端汽车	什么
图形商标蓝白标记对称图	怎样
主要车系1、2、3、4、5、6、7、i、m、x、z等几个系列	什么
世界500强排名2018年位列16位	多少
旗下品牌劳斯莱斯	什么
旗下品牌mini	什么
旗下品牌宝马	什么
类别公司	什么
类别汽车品牌	什么
生产厂家宝马汽车集团	谁
车型小型两厢车	什么
创始人亚历克·伊兹高尼	谁
车型小型汽车	什么
车型小型轿跑	什么
车型中型汽车	什么
车型中型轿跑	什么
车型中大型汽车	什么
车型中大型轿跑	什么
车型豪华d级车	什么
车型电动车	什么
车型混合动力车	什么
车型跑车	什么
车型suv车系	什么
车型入门级跑车	什么
外文名mercedes benz	什么
创立时间1926年	什么时候
创始人卡尔·弗里特立奇·本茨	谁
总部地点德国斯图加特	哪里
图形商标三星叉	什么
年产量近百万辆	多少
旗下品牌奔驰	什么
旗下品牌smart	什么
旗下品牌迈巴赫	什么
外文名maybach	什么
生产厂家奔驰汽车集团	谁
创立时间1921年	什么时候
创始人威廉·迈巴赫	谁
全名梅赛德斯-奔驰	什么
外文名mercedes-benz	什么
创立时间1883年	什么时候
主要车系奔驰a系	什么
主要车系奔驰b系	什么
主要车系奔驰c系	什么
主要车系奔驰e系	什么
主要车系奔驰s系	什么
主要车系奔驰g系	什么
主要车系奔驰glc系	什么
主要车系奔驰slk系	什么
车型小型轿车	什么
车型紧凑型旅行轿车	什么
车型中型轿车	什么
车型全新紧凑型四门轿跑车	什么
车型中型跑车	什么
车型中大型跑车	什么
车型行政级轿车	什么
车型商务用车	什么
车型大型豪华轿车	什么
车型越野车	什么
车型中型suv	什么
车型紧凑suv	什么
车型中大型suv	什么
外文名ford motor company	什么
总部地点美国密歇根州迪尔伯恩	哪里
创立时间1903年	什么时候
经营中高端汽车	什么
2015年营业额1495.58亿美元	多少
2015员工数199,000人	多少
创始人亨利·福特	谁
主要车系探险者	什么
主要车系锐界	什么
主要车系福克斯	什么
主要车系蒙迪欧	什么
旗下品牌福特	什么
旗下品牌林肯	什么
2018年世界五百排名第45位	多少
图形商标蓝色英文	怎样
所属行业汽车设计制造	什么
外文名ford	什么
生产厂家福特汽车集团	谁
外文名lincoln	什么
外文名toyota motor corporation	什么
国别日本	什么
总部地点日本东京	哪里
创立时间1937年8月28日	什么时候
创始人丰田喜一郎	谁
经营汽车	什么
公司类型民营企业	什么
2015年年营业额2365.91亿美元	多少
2015年员工数348877	多少
2018年世界五百强排名第6位	多少
图形商标红色椭圆	怎样
旗下品牌丰田	什么
旗下品牌雷克萨斯	什么
旗下品牌斯巴鲁	什么
旗下品牌塞恩	什么
旗下品牌大发	什么
生产厂家丰田汽车集团	谁
外文名toyoto	什么
外文名volks wagenwerk	什么
总部地点德国沃尔夫斯堡	哪里
创立时间1938年	什么时候
创始人费迪南德·保时捷	谁
经营汽车设计制造	什么
员工数60余万人	多少
旗下品牌宾利	什么
旗下品牌保时捷	什么
旗下品牌奥迪	什么
旗下品牌斯柯达	什么
董事长马蒂亚斯·穆勒	谁
图形商标vw字母	什么
生产厂家大众汽车集团	谁
外文名bentley	什么
创立时间1919年8月	什么时候
主要车系添越	什么
主要车系欧陆	什么
主要车系飞驰	什么
主要车系慕尚	什么
品牌定位高端汽车	什么
外文名porsche ag	什么
创立时间1931年	什么时候
外文名audi	什么
图形商标四环相扣	什么
创立时间1909年	什么时候
主要车系a1、a3、a4、a5、a6、a7、a8、q1、q2、q3、q5、q7、q8、tt、r8以及s、rs性能系列等	什么
外文名skoda	什么
主要车系明锐	什么
主要车系昊锐	什么
主要车系晶锐	什么
创立时间1963年	什么时候
外文名automobili lamborghini s.p.a	什么
主要车系gallardo	什么
主要车系aventador	什么
主要车系huracan	什么
生产厂家一汽·大众	谁
价格11.6-23.58万元	多少
车型经典掀背/小型家用车型	什么
首次推出时间1974年	什么时候
保修政策2年不限公里	多少
推出年款2011年7月20日	什么时候
气门结构双顶置凸轮轴	怎样
生产厂家大众	谁
类别汽车单品	什么
推出年款2012	什么时候
车型紧凑型	什么
生产厂家一汽大众	谁
推出年款2012-05-16	什么时候
排量1.4	多少
轴距2578	多少
产地属性进口	哪里
款型2011	什么时候
级别属性紧凑型车	什么
推出年款2011	什么时候
车型旅行车	什么
外文名honda	什么
总部地点日本东京都港区南青山2-1-1	哪里
创立时间1948年9月	什么时候
经营摩托车	什么
公司类型 跨国汽车、摩托车生产销售集团	什么
2015年营业额1216.24亿美元	多少
2015年员工数208,399人	多少
创始人本田宗一郎	谁
主要车系雅阁	什么
主要车系思域	什么
主要车系凌派	什么
主要车系歌诗图	什么
2019年世界五百强排名第34位	多少
生产厂家本田株式会社	谁
品牌定位中档汽车	什么
创立时间1976年	什么时候
外文名nissan	什么
总部地点日本横滨	哪里
创立时间1933年	什么时候
创始人田建治郎	谁
经营中端汽车	什么
2015年营业额1015.36亿美元	多少
2015年员工数152,421人	多少
2016年世界五百强排名第53位	多少
旗下品牌雷诺	什么
旗下品牌日产	什么
旗下品牌无限	什么
旗下品牌英菲尼迪	什么
图形商标圈圈里面nissan字母	怎样
外文名general motors corporation	什么
总部地点美国密歇根州底特律	哪里
创立时间1908年9月16日	什么时候
创始人威廉·杜兰特	谁
2017年营业额1663.80亿美元	多少
2017年员工数225,000人	多少
2017年世界五百强排名第18位	多少
旗下品牌雪佛兰	什么
旗下品牌别克	什么
旗下品牌gmc	什么
旗下品牌凯迪拉克	什么
旗下品牌宝骏	什么
旗下品牌五菱	什么
旗下品牌欧宝	什么
图形商标gm字母	什么
类别通用汽车集团	什么
外文名buick	什么
创立时间1904年	什么时候
创始人大卫·邓巴·别克	谁
品牌定位中高端汽车	什么
图形商标三个盾牌	怎样
外文名chevrolet	什么
创立时间1911年	什么时候
外文名gmc	什么
车型豪华型商务旅行车	什么
外文名cadillac	什么
创立时间1902年	什么时候
创始人亨利·利兰	谁
品牌定位豪华汽车跑车	什么
外文名opel	什么
外文名fifa	什么
国别意大利	什么
总部地点意大利都灵市	哪里
创立时间1899年	什么时候
创始人乔瓦尼·阿涅利	谁
旗下品牌菲亚特	什么
旗下品牌法拉利	什么
旗下品牌阿尔法	什么
生产厂家菲亚特集团	谁
创立时间1910年	什么时候
国别法国	什么
创立时间1898年	什么时候
创始人路易斯·雷诺	谁
主要产品汽车	什么
主要产品货车	什么
总部地点布洛涅-比扬古	哪里
2015年营业额502.80亿美元	多少
经营中高端汽车生产	什么
2015年员工数120,136人	多少
图形商标四个菱形拼成的图案	怎样
世界500强排名位列143位	多少
外文名groupe psa	什么
旗下品牌标致	什么
旗下品牌雪铁龙	什么
旗下品牌ds	什么
旗下品牌沃克斯豪尔	什么
经营汽车零件	什么
总部地点吕埃尔-马尔迈松镇	哪里
外文名peugeot	什么
生产厂家标致雪铁龙集团	谁
外文名seat	什么
创立时间1950年	什么时候
国别西班牙	什么
国别韩国	什么
外文名hyundai kia	什么
创始人郑周永	谁
旗下品牌现代	什么
旗下品牌起亚	什么
创立时间1967年	什么时候
外文名hyundai	什么
生产厂家现代起亚集团	谁
创立时间1947年	什么时候
图形商标椭圆内有斜字母h	怎样
主要车型suv	什么
主要车型普通家用轿车	什么
外文名kia	什么
创立时间1944年	什么时候
图形商标由白色的椭圆、红色的背景和黑体的“kia”三个字母构成	什么
外文名mitsubishi	什么
创立时间1873年	什么时候
创始人岩崎弥太郎	谁
外文名chrysler corporation	什么
总部地点美国密歇根州	哪里
创立时间1925年	什么时候
旗下品牌克莱斯勒	什么
旗下品牌道奇	什么
旗下品牌吉普	什么
外文名dodge	什么
创始人约翰·道奇	谁
创始人霍瑞德·道奇	谁
图形商标公羊	什么
外文名jeep	什么
生产厂家克莱斯勒汽车集团	谁
主要车型运动型多用途车	什么
代言人王石	谁
代言人刘强东	谁
代言人谢霆锋	谁
所属品牌mini	什么
驱动方式前置发动机前轮驱动	怎样
排量1.6l	多少
优点安全性高	什么
缺点爆发力不强	什么
价格18.38-29.98万	多少
油耗平均6.8升/100公里	多少
优点五车门、空间大	什么
价格23.78-32.78万	多少
所属品牌丰田	什么
车型紧凑型轿车	什么
车门数5开门	多少
排量5.513l	多少
最高转速6000rpm	多少
驱动方式前置后驱	怎样
环保标准欧iv	什么
车门数4	多少
变速器形式手自一体	怎样
所属品牌奥迪	什么
车型中型车	什么
发动机3.0t v型6缸 涡轮增压	什么
最大功率260kw	多少
环保标准国五	多少
驱动方式全时四驱	怎样
外文名peugeot hoggar	什么
所属品牌标致	什么
特点野性和壮观	什么
功率高达360匹马	多少
发动机hdi发动机	什么
名称来源与阿尔及利亚南部沙漠hoggar形象相似	什么
车型运动型车	什么
外文名peugeot 505	什么
发动机直列4缸	多少
容量1971cc / 2165cc 1971cc / 2165cc	多少
功率96 kw (sti)	多少
最高时速每小时200公里	多少
轴距2900mm	多少
外文名peugeot type 66	什么
车型大型车	什么
排量5.0l	多少
功率25马力	多少
发动机四缸	多少
开始生产时间1904年	什么时候
最高时速87km/h	多少
外文名alfa romeo stelvio	什么
所属品牌阿尔法	什么
车型suv	什么
价格471,800rmb	多少
轴距2818 毫米	多少
最大功率280马力	多少
扭矩400牛米/2250 转	多少
最高车速230公里/每小时	多少
燃油箱容积64升	多少
外文名ford mustang	什么
所属品牌福特	什么
开始生产时间1964年	什么时候
特点具有长引擎盖和短后甲板	什么
中国总代理北京丰宝驰汽车贸易有限公司	谁
竞争对手通用汽车camaro	谁
竞争对手amc javelin	谁
外文名ford falcon	什么
轴距2,838毫米	多少
车门数4开门	多少
外文名toyota avalon	什么
价格208,800~289,800rmb	多少
轴距2870mm	多少
发动机类型l4	什么
排量2.5l	多少
最大功率154kw	多少
驱动方式前轮驱动	怎样
转向系统eps电子助力转向系统	什么
制动系统(前/后)通风盘式	怎样
车型轿车	什么
外文名toyota rav4	什么
价格176,800~264,800rmb	多少
最大功率111kw	多少
最大扭矩3800 rpm	多少
压缩比10.5:1	多少
最高车速175km/h	多少
外文名buick velite	什么
设计理念精英和中坚力量	什么
发动机双涡轮增压中冷式v6发动机	怎样
最大功率400匹马力	多少
0-100公里/小时加速时间5.5秒	多少
最大扭矩542牛顿·米	多少
所属品牌别克	什么
排量3.6l	多少
驱动方式前置后轮驱动	怎样
外文名chevrolet cobalt	什么
发动机ecotec四汽缸发动机	什么
所属品牌雪佛兰	什么
功率140匹马力	多少
扭矩150磅	多少
轴距2624mm	多少
整备质量1456kg	多少
最小转弯直径10.6m	多少
燃油箱容积52ml	多少
行李箱容积394l	多少
车门数4个	多少
外文名iav gmbh	什么
公司性质汽车供应商	什么
主要客户大众汽车集团	谁
主要客户宝马	谁
主要客户psa标致雪铁龙	谁
主要客户菲亚特	谁
主要客户福特汽车公司	谁
主要客户通用	谁
主要客户保时捷	谁
主要客户丰田	谁
创立时间2009年	什么时候
国别比利时	什么
创立时间1985年	什么时候
经营航空航天	什么
经营工程	什么
创立时间1970年	什么时候
总部地点塞萨洛尼基	哪里
国别希腊	什么
创立时间2001年	什么时候
国别波兰	什么
经营公交	什么
年产量大约100-150辆公共汽车	多少
公司性质机床制造商	什么
总部地点加利福尼亚州	哪里
公司性质技术设计和制造公司	什么
主要产品汽车，航空，能源和安全市场的先进系统	什么
上市情况已上市	怎样
公司性质嵌入式语音技术公司	什么
创立时间2000年	什么时候
总部地点瑞士苏黎世	哪里
主要产品自动语音识别	什么
主要产品文字转语音	什么
主要产品语音对话系统	什么
客户汽车制造商	谁
总部地点荷兰	哪里
公司类型数字地图服务提供商	什么
主要业务数字地图的内容聚合，编译和测试，用于导航	什么
总部地点密歇根州诺维市	哪里
行业竞争力全球领先	什么
主要产品车身密封系统	什么
主要产品流体处理系统	什么
主要产品nvh控制系统	什么
国别荷兰	什么
经营飞机	什么
主要产品小型飞机	什么
类别装甲战斗车	什么
功能抵抗反车辆地雷和简易弹药	什么
生产厂家force protection inc	谁
设计时间2004年	什么时候
类别活动	什么
类别车展	什么
举办间隔两年一届	多少
举办间隔每年一届	多少
创办时间1905年	什么时候
举办时间每年1月	什么时候
创办时间1954年	什么时候
类别指标	什么
种类汽车性能指标	什么
种类车身造型	什么
类别汽车评价指标	什么
种类汽车动力性指标	什么
种类燃油经济性指标	什么
种类汽车制动性指标	什么
种类操控稳定性指标	什么
种类平顺性指标	什么
种类通过性指标	什么
种类安全性指标	什么
类别汽车性能指标	什么
种类最高车速	什么
种类汽车加速时间	什么
定义汽车在道路上行驶时能达到的最大速度，数值越大，动力性就越好	什么
类别汽车动力性指标	什么
种类原地起步加速时间	什么
种类超车加速时间	什么
定义指汽车从静止状态下，由第一挡起步，并以最大的加速强度（包括选择最恰当的换挡时机）逐步换至高挡后，到某一预定的距离车速或车速所需的时间	什么
定义用最高挡或次高挡全力加速至某一高速所需要的时间	什么
定义指气缸总容积与燃烧室容积的比值，它表示活塞从下止点移到上止点时气缸内气体被压缩的程度。	什么
定义使物体发生转动的力，发动机的扭矩是指发动机从曲轴端输出的力矩	什么
定义汽车转向时，汽车外侧转向轮的中心平面在车辆支承平面上的轨迹圆半径	什么
影响因素行驶速度	什么
影响因素汽车的保养与调整	什么
定义汽车在道路上行驶时每百公里平均燃料消耗量	什么
中国单位l/100km	什么
欧洲单位l/100km	什么
美国单位mpg或mi/gall	什么
种类制动效能	什么
种类制动效能的恒定性	什么
种类制动时汽车的方向稳定性	什么
类别汽车制动性指标	什么
定义汽车在良好路面上以一定初速度制动到停车的制动距离，制动距离越短制动性能越好	什么
定义指汽车高速行驶下长坡连续制动时，制动器连续制动效能保持的程度	什么
定义汽车制动时不发生跑偏、侧滑以及失去转向能力的性能	什么
定义指司机在不感到紧张、疲劳的情况下，汽车能按照司机通过转向系统给定的方向行驶，而当遇到外界干扰时，汽车所能抵抗干扰而保持稳定行驶的能力	什么
定义保持汽车在行驶过程中，乘员所处的振动环境具有一定的舒适度的性能	什么
影响因素与汽车的底盘参数、车身几何参数，以及汽车的动力性以及操控性等有密切关系	什么
定义车辆通过一定情况路况的能力，譬如坡度较大的坡道、积水路段等	什么
种类最大爬坡度	什么
种类最小离地间隙	什么
种类最大涉水深度	什么
种类接近角	什么
种类离去角	什么
定义汽车满载时的最大爬坡能力	什么
类别汽车通过性指标	什么
定义指满载、静止时，汽车除车轮之外的最低点与支撑平面之间的距离	什么
定义汽车所能通过的最深水域	什么
定义指在汽车满载静止时，汽车前端突出点向前轮所引切线与地面的夹角	什么
定义指汽车满载、静止时，自车身后端突出点向后车轮引切线与路面之间的夹角	什么
定义汽车利用效率和方便性	什么
类别使用性指标	什么
种类结构吸能性	什么
种类内饰软化	什么
种类汽车安全防护装置	什么
类别安全性指标	什么
定义指汽车在发生碰撞时，汽车结构吸收大部分冲击能量，从而保证座舱变形最小，不挤伤乘员的能力	什么
实现结构防撞梁	什么
实现结构吸能盒	什么
定义汽车座舱内部的各种器件表面无凸起，材质柔软有弹性，尽可能减少尖角、突棱和突出的零件，在发生碰撞时能减少乘员所受的伤害	什么
实现结构转向盘、仪表板、侧围、顶篷、座椅、地板以及遮阳板等突出的附件	什么
种类安全玻璃	什么
种类安全带	什么
种类防抱死制动系统	什么
种类安全气囊	什么
种类高位刹车灯	什么
种类碰撞缓冲区	什么
类别汽车安全防护装置	什么
作用在撞击的时候，预紧器可以把安全带拉紧，防止由于松懈而带来会造成身体伤害的位移。撞击结束后，力道限制器可以使安全带略微松弛以减轻对车内乘员的压力	什么
作用旨在减轻乘员的伤害程度，当发生碰撞事故时，避免乘员发生二次碰撞，或车辆发生翻滚等危险情况下被抛离座位	什么
作用防止追尾事故发生	什么
别名第三刹车灯	什么
安装位置车尾上部	哪里
作用在发生撞击时车身发生逐渐变形，以吸附事故中产生的绝大部分(如果不是全部)的撞击能量	什么
种类车重	什么
种类车长	什么
种类车门数	什么
种类轮距	什么
种类轴距	什么
类别车身造型	什么
定义汽车完全装备好的质量，包括润滑油、燃料、随车工具、备胎等所有装置的质量	什么
定义汽车长度方向两极端点间的距离	什么
定义以轮毂数为计量依据	什么
定义汽车前轴中心至后轴中心的距离	什么
定义同一车轿左右轮胎胎面中心线间的距离	什么
定义指前轮中心与车前端的水平距离	什么
定义汽车最后端至后轴中心的水平距离	什么
构成汽车	什么
类别汽车基本结构	什么
类别汽车零件	什么
定义控制空气进入发动机的一道可控阀门	什么
外文名throttle valve	什么
类别发动机配件	什么
种类直列式	什么
种类分配式	什么
种类单体式	什么
供应商电装（中国）投资有限公司	谁
供应商迪安汽车部件（天津）有限公司	谁
供应商德西福格汽车配件（平湖）有限公司	谁
供应商无锡摩比斯汽车零部件有限公司	谁
参数范围温度在-45-420摄氏度之间	多少
参数范围流量在6.25-500m3/h之间	多少
参数范围扬程在35-603m之间	多少
定义用于汽车传动系统的皮带张紧装置	什么
构成涨紧轮	什么
作用调节正时皮带的松紧度	什么
特点皮带松紧程度自己调整	什么
支承骨架活塞	什么
支承骨架曲轴	什么
作用将各个气缸和曲轴箱连成一体	什么
工作条件恶劣	什么
安装位置发动机主体中	哪里
接触部分滑动轴承	什么
接触部分轴颈	什么
制作材料青铜	什么
制作材料聚合物	什么
制作材料石墨	什么
制作材料陶瓷	什么
作用承受连杆传来的力，并将其转变为转矩通过曲轴输出并驱动发动机上其他附件工作	什么
构成曲轴	什么
制作材料铜	什么
制作材料不锈钢	什么
制作材料铁	什么
制作材料铝	什么
制作材料石棉	什么
制作材料纸	什么
制作材料橡胶	什么
类别发动机	什么
控制气门的开启	什么
控制气门的闭合	什么
作用汽车的动力装置	什么
外文名engine	什么
种类发动机动力性指标	什么
种类发动机经济性指标	什么
种类环境指标	什么
类别发动机评价指标	什么
参数发动机有效功率	什么
参数发动机转速	什么
参数有效燃油消耗率	什么
参数汽车排放标准	什么
参数汽车噪声水平	什么
类别发动机动力性指标	什么
简称轴功率	什么
定义发动机机轴上所净输出的功率	什么
单位kw	什么
外文名revolutions per minute	什么
定义发动机曲轴每分钟的回转数	什么
单位r/min	什么
正常区间3000-5000r/min	多少
表示符号n	什么
定义单位有效功的耗油量	什么
简称耗油率	什么
单位克/马力小时，即g/(kw·h)	什么
冷却方式空气冷却	怎样
冷却方式水冷却	怎样
种类柴油发动机	什么
种类汽油发动机	什么
种类电动机	什么
外文名gasoline engine	什么
优点转速高，质量小，噪音小，起动容易，制造成本低	什么
使用往复活塞式内燃机	什么
工作原理将空气与汽油以一定的比例混合成良好的混合气，在吸气冲程被吸入汽缸，混合气经压缩点火燃烧而产生热能，高温高压的气体作用于活塞顶部，推动活塞作往复直线运动，通过连杆、曲轴飞轮机构对外输出机械能	什么
优点压缩比大，热效率高，经济性能和排放性能都比汽油机好	什么
工作原理将空气与柴油以一定的比例混合成良好的混合气，在吸气冲程被吸入汽缸，混合气经压缩点火燃烧而产生热能，高温高压的气体作用于活塞顶部，推动活塞作往复直线运动，通过连杆、曲轴飞轮机构对外输出机械能	什么
定义活塞在气缸内作往复直线运动的活塞式内燃机	什么
优点效率高、体积小、质量轻和功率大	什么
种类v型发动机	什么
种类w型发动机	什么
定义将相邻气缸以一定的角度组合在一起，从侧面看像v字型	什么
优点v型发动机的气缸是成一个角度对向布置的，可以抵消一部分的震动	什么
缺点必须要使用两个气缸盖，结构相对复杂	什么
定义将v型发动机两侧的气缸再进行小角度的错开，就是w型发动机了	什么
优点曲轴可更短一些，重量也可轻化些	什么
缺点w型发动机结构上被分割成两个部分，结构更为复杂，在运作时会产生很大的震动，所以只有在少数的车上应用	什么
构成发动机	什么
构成冷却系	什么
别名燃料供给系统	什么
外文名fuel feed system	什么
工作冲程进气、压缩、作功、排气	什么
别名起动系	什么
外文名starting system	什么
作用将蓄电池内的电能转换为机械能	什么
thp含义turbo high performance	什么
类别涡轮增压发动机	什么
简称1.6thp发动机	什么
类别柴油发动机	什么
开发集团奇瑞公司	什么
优点高效、节能、环保	什么
排放标准cn iv	什么
最大功率105/4000	多少
最大扭矩302/2000	多少
最高转速2450rpm	多少
缸径150	多少
额定转速2200rpm	多少
公司三菱	什么
年产量10万台	多少
投产地沈阳	哪里
投资金额4.2亿	多少
缸体材质铝	什么
中间耗油率0.795kg/(daN·h)	多少
类别涡喷发动机	什么
加力耗油率2.00kg/(daN·h)	多少
原产国俄罗斯	哪里
最大加力推力12258(dan)	多少
最大直径1300(mm)	多少
最大空气流量112.0kg/s	多少
涡轮进口温度1392℃	多少
质量1530(kg)	多少
长度4950(mm)	多少
类别缸内直喷发动机	什么
特点优化了进气混合效率	什么
定义输送液体或使液体增压的机械	什么
种类离心泵	什么
种类往复泵	什么
种类混流泵	什么
定义控制冷却液流动路径的阀门	什么
作用控制发动机冷却液及进气温度	什么
工作原理感知冷却液温度控制自身阀门开闭	什么
构成润滑系	什么
作用将机油提高到一定压力后，强制地压送到发动机各零件的运动表面上	什么
种类齿轮式	什么
种类转子式	什么
类别机油泵	什么
种类内接齿轮式	什么
种类外接齿轮式	什么
定义润滑油进入油孔的通道	什么
作用滤除机油中的杂物、胶质和水分，向各润滑部位输送清洁的机油	什么
定义发动机的空气、机油、燃油三种滤清器，车内有空调滤清器	什么
作用担负发动机进气系统、润滑系统、燃油系统、空调系统中介质的过滤	什么
构成燃料供给系	什么
种类化油器式	什么
种类电喷式	什么
作用滤除燃汽油杂质	什么
定义清除空气中的微粒杂质的装置	什么
构成空气滤清器	什么
作用将汽油从油箱中吸出，并经管路和汽油滤清器压送到化油器的浮子室内	什么
驱动方式机械驱动膜片式	怎样
驱动方式电驱动式两种	怎样
定义在发动机工作产生的真空作用下，将一定比例的汽油与空气混合的机械装置	什么
用途根据发动机的不同工作状态需求，自动配比出相应的浓度，输出相应的量的混合气	什么
构成点火系	什么
定义汽油机点火系统中将高压电流引入气缸产生电火花，以点燃可燃混合气体的部件	什么
别名火嘴	什么
构成火花塞	什么
工作原理电板经由反复持续的发电点火，点燃汽缸内的混合气，点火系统的其它部分则产生正时的高压电脉冲，形成火花并产生爆炸提供引擎动力输出所需的能源	什么
作用点火系中作适时控制初级电路通断	什么
构成启动系	什么
作用将蓄电池的电能转换成机械能	什么
定义发动机的主要运动机构	什么
作用提供燃烧场所	什么
构成曲柄连杆机构	什么
定义构成发动机的骨架	什么
类别曲柄连杆机构	什么
构成活塞连杆组	什么
作用与气缸盖、气缸壁等共同包含燃烧室，并承受气缸中气体压力	什么
作用安装在活塞环槽内，用来密封活塞与气缸壁之间的间隙	什么
作用连接活塞和连杆小头，并将活塞所受的气体作用力传给连杆	什么
作用将活塞承受的力传给曲轴，并使活塞的往复运动转变为曲轴的旋转运动	什么
构成曲轴飞轮组	什么
构成配气机构	什么
主要故障凸轮轴响	什么
主要故障气门脚响	什么
种类气门顶置式	什么
种类气门侧置式	什么
作用捕集粉尘，净化空气	什么
工作原理通过多孔过滤制作材料的作用从气固两相流中捕集粉尘	什么
冷却发动机	什么
构成汽缸盖	什么
制作材料铸铁	什么
制作材料铝合金	什么
外文名cylinder head	什么
安装基体汽缸盖	什么
工艺要求强度	怎样
工艺要求刚度	怎样
密封气缸	什么
承受气体力	什么
承受热负荷	什么
避免热裂纹	什么
形状箱型	怎样
结构形式整体式	怎样
结构形式分块式	怎样
结构形式单体式	怎样
经营汽缸盖	什么
地点济南	哪里
经营模式生产加工	怎样
创立时间1997年	什么时候
创立时间2007年	什么时候
地点武汉	哪里
定义是与发动机气缸体相连的，将各缸的排气集中起来导入排气总管，带有分歧的管路	什么
类别v6发动机	什么
开发集团标致雪铁龙和雷诺共同开发	什么
推出时间1997年	什么时候
金属材质铝	什么
作用承受发动机动力，保证正常行驶	什么
构成底盘	什么
构成传动系	什么
作用使发动机的动力与传动装置平稳地接合或暂时地分离	什么
种类电磁离合器	什么
种类磁粉离合器	什么
构成离合器	什么
安装位置发动机和变速箱之间的飞轮壳内	哪里
类别离合器	什么
使用步骤5步	多少
保养维护5条	什么
外文名electromagnetic clutches	什么
工作方式通电结合和断电结合	怎样
种类5	什么
优点无冲击振动	什么
优点无噪音	什么
优点无污染	什么
外文名magnetic particle clutch	什么
特点响应速度快	什么
特点结构简单	什么
专利申请人德国kegresse.a	谁
优点缩短换档时间	什么
外文名double clutch	什么
安装位置发动机与变速器之间	哪里
作用保证汽车平稳起步	什么
作用保证汽车平稳起步等	什么
种类滚子式和楔块式单向离合器	什么
构成单向离合器	什么
优点维修简便	什么
优点故障率低	什么
优点舒适性适中	什么
简称acs	什么
系统平均功耗≤3w	多少
适用范围手动车型车	什么
开发集团辽宁中泰机械有限公司	什么
中文名同步自换档	什么
发明者英国人	谁
外文名synchro-self-shifting	什么
温度环境－20—50℃	多少
种类多片电磁离合器	什么
种类干式单片	什么
外文名electromagnetic cultches	什么
特点径向尺寸小	什么
特点力矩大	什么
温度环境周围空气温度为-5℃-+40℃	多少
主机额定扭矩ml	多少
扭矩储备系数k	多少
摩擦系数μ	多少
特点起动和换向平稳	什么
特点无冲击	什么
优点自动补偿摩擦元件的磨损	什么
适用范围工程机械	什么
适用范围远距离操纵的机床	什么
作用改变传动比、实现汽车倒驶等	什么
种类手动变速器	什么
种类自动变速器	什么
类别变速器	什么
定义必须通过用手拨动变速器杆，才能改变传动比的变速器	什么
构成手动变速器	什么
工作原理通过拨动变速杆，切换中间轴上的主动齿轮，通过大小不同的齿轮组合与动力输出轴结合，从而改变驱动轮的转矩和转速	什么
别名自动变速箱	什么
别名自排变速箱	什么
别名automatic transmission	什么
别名at	什么
定义可以在车辆行驶过程中自动改变齿轮传动比的汽车变速器，从而使驾驶员不必手动换档	什么
构成自动变速器	什么
种类液力自动变速器	什么
种类机械式无级变速器	什么
种类电控机械式自动变速器	什么
种类双离合变速器	什么
外文名at	什么
类别自动变速器	什么
定义由液力变扭器和行星齿轮变速器组合而成的变速器	什么
构成液力变矩器	什么
构成行星齿轮变速器	什么
工作原理通过液力传递和齿轮组合的方式来达到变速变矩	什么
定义能改变所传递扭矩的液力传动装置	什么
作用将发动机的动力输出传递到变速机构	什么
构成液力变扭器	什么
类别液力变扭器构成部分	什么
作用当车速超过一定速度时，采用锁止离合器将发动机与变速机构直接连接，这样可以减少燃油消耗	什么
构成行星齿轮	什么
工作原理当行星架、齿圈以及太阳轮三个部件中的一个被固定后，动力便会在其他两个部件之间传递	什么
外文名cvt	什么
定义由离合器和依据车速、油门开度改变，v型带轮的半径变化而实现无级变速的变速器	什么
工作原理通过链带和锥形轮的距离来变速	什么
外文名amt	什么
定义在传统干式离合器和手动齿轮变速器的基础上，加装电子控制系统，将手动换档机构改造成自动换档机构，从而实现自动换档的有级式机械自动变速器	什么
工作原理电子控制单元根据换档规律、离合器控制规律、发动机节气门自适应调节规律产生的输出，对节气门开度、离合器、换档操纵三者进行综合控制	什么
优点传动效率高、成本低	什么
缺点存在动力中断，换档平顺性较差的缺点	什么
外文名dsg	什么
定义有两个离合器的变速器，其中一个负责奇数档，另一个离合器负责偶数档	什么
工作原理用“双”离合器控制与发动机动力的通断，这两台自动控制的离合器，由电子控制及液压推动，能同时控制两组离合器的运作	什么
优点换挡快，提供无间断的动力输出	什么
缺点成本高	什么
定义变速器完成传动比的变换过程称换档	什么
定义从动齿轮的齿数与主动齿轮的齿数之比	什么
定义与输出轴连接为一体的齿轮被迫转动	什么
定义固定在输入轴上的齿轮随之同步转动，该齿轮称为主动齿轮	什么
外文名grade place	什么
定义车、船交通工具变速箱的次序，计量工具中的调节计量单位的次序等	什么
种类倒挡	什么
种类空挡	什么
种类前进挡	什么
定义能够使汽车向前行驶的档位	什么
定义能够使汽车倒退行驶的档位	什么
定义变速器中各档齿轮都不在工作位置上	什么
定义汽车行驶中因接合齿磨损和振动等原因，导致接合套与接合齿圈分开而使变速器处在空档状态	什么
作用实现变角度动力传递的机件	什么
别名万向接头	什么
种类刚性万向节	什么
种类挠性万向节	什么
适用范围汽车	什么
定义在扭转方向上有明显弹性的万向节	什么
定义在扭转方向上无明显弹性的万向节	什么
作用增扭，降速，改变转矩传递方向	多少
种类非断开式	什么
种类断开式	什么
构成行驶系	什么
作用支持全车质量并保证汽车的行驶	什么
定义连接在各车桥之间形似桥梁的一种结构，是整个汽车的安装基础。	什么
作用安装汽车的各总成和部件，使它们保持正确的相对位置，并承受来自车上和地面的各种静动载荷	什么
作用传递车架或承载式车身与车轮之间各方向的作用力。	什么
种类转向桥	什么
种类驱动桥	什么
种类转向驱动桥	什么
种类支持桥	什么
定义外部装轮胎，中心装车轴并承受负荷的旋转部件	什么
作用支承汽车及货物总质量，保证车轮和路面的附着性	什么
定义车架与车桥之间一切传递动力连接装置	什么
作用改变或恢复行驶方向	什么
构成转向系	什么
工作原理利用与车身（或车架）相连的非旋转元件和与车轮（或传动轴）相连的旋转元件之间的相互摩擦来阻止车轮的转动或转动的趋势	什么
作用使得车辆在短时间内强制停车	什么时候
构成制动系	什么
定义用以使外界(主要是路面)在汽车某些部分(主要是车轮)施加一定的力，从而对其进行一定程度的强制制动的一系列专门装置	什么
定义产生阻碍车辆运动或运动趋势的部件	什么
外文名abs	什么
外文名anti-lockbraking system	什么
作用在汽车制动时，自动控制制动器制动力的大小，使车轮不被抱死	什么
作用用以驾驶员、旅客乘坐或装载货物	什么
构成车身	什么
定义在各种车辆或机械上装配的接地滚动的圆环形弹性橡胶制品	什么
作用传送牵引和制动扭力	什么
主要材质橡胶	什么
构成轮胎	什么
工作原理通过其花纹块与路面产生的磨擦力，成为汽车驱动、制动和转向的动力之源	什么
年产量1.9亿条	多少
公司口号引领进步之道	什么
2015年营业额235.16亿美元（年）	多少
2016年营业额250.5亿美元（年）	多少
员工数105,798人（2015年）	多少
主要生产轮胎	什么
总部地点法国克莱蒙费	哪里
创立时间1889年	什么时候
外文名banded at zero technology	什么
定义在钢丝带束层的上部胎面区域使用了螺旋式缠绕的聚酰胺覆盖条，可以抵御高速行驶时可能导致轮胎变形的离心力	什么
优点优化了车辆的高速操控性和轮胎的耐久性	什么
行驶里程50-70公里	多少
适合备用量3个	多少
种类全尺寸备胎	什么
种类非全尺寸备胎	什么
种类零压轮胎	什么
定义规格大小与原车其他4条轮胎完全相同	什么
定义直径和宽度都要比其他4条轮胎略小,因此只能做为临时代替使用,而且只能用于非驱动轮	什么
最高时速不能超过80km/h	多少
类别轮胎	什么
别名安全轮胎	什么
别名run-flat tire	什么
别名防爆轮胎	什么
主要产品emt	什么
别名零压轮胎	什么
功能安全行驶	什么
外文名run-flat tire	什么
起源时间1934年	什么时候
充气压力0.1471～0.490mpa	多少
特点受热后膨胀就小	什么
特点相对安全	什么
相应气压0.0657mpa(6.7kgf/cm2)	多少
种类黏结式	什么
种类非黏结式	什么
制作材料橡胶材料	什么
外文名solid tire	什么
特点散热强	什么
特点高弹性	什么
特点耐磨性好	什么
适用范围低速行驶的高负荷车辆或机械	什么
优点节约燃油	什么
优点增加车辆的安全性	什么
外文名wide base tyre	什么
应用场景日本公交行业	什么
外文名bias tire	什么
构成工程轮胎	什么
要求良好的耐磨性能生热少	怎样
地位汽车的双脚	怎样
型号53/80r63	什么
目的降低运输成本	什么
发明者罗伯特·汤姆逊	谁
发明时间1845年	什么时候
特点滚动阻力小	什么
适用范围各种规格轮胎	什么
结构空心胎	怎样
结构空腔结构	怎样
外文名multi-chambered tyre	什么
特点重量大	什么
特点造价高	什么
定义双腔或三腔的无内胎轮胎	什么
公司性质国有企业	什么
员工数5000人	多少
创立时间1992年4月8日	什么时候
全名江苏三元轮胎有限公司	什么
地点三元公司	哪里
时间1997年	什么时候
主要产品轿车和轻卡子午胎	什么
地位供产销研一体化轮胎企业	怎样
主要型号195/65r15	什么
主要型号205/60r15	什么
公司横滨橡胶株式会社	什么
地区日本	哪里
创立时间1917年	什么时候
后果造成巨大的资源浪费	怎样
回收利用率50%左右	多少
数量以8%至10%的速度递增	多少
类别参数	什么
定义轮胎横断面的高度和宽度比就是轮胎的扁平率	什么
外文名arched tyre	什么
外文名arch-type tyre	什么
别名普通结构轮胎	什么
特点纵向刚性好	什么
适于路面普通路面	什么
别名原子胎	什么
别名真空胎	什么
外文名tubeless tires	什么
特点质量轻	什么
特点使用寿命长	什么
作用具有减震作用	什么
开发集团米其林公司	谁
结构非常类似于自行车车轮	怎样
优点较高的弹性和耐磨性等	什么
注意必须保持规定的气压等	什么
特点人员更舒适	什么
别名矽胶轮胎	什么
别名硅橡胶轮胎	什么
材质室温硫化硅胶	什么
特点材料对人体无害	什么
特点化学稳定性好	什么
功能能提高汽车的舒适度和安全系数	什么
安全性汽车安全方面第四大安全保障	什么
材质高分子合成材料	什么
特点不伤害轮辋	什么
特点胎圈	什么
用法自然风干即可	怎样
用途各种轮胎的光亮	什么
用途增光	什么
用途增黑处理	什么
别名充气机	什么
别名打气机	什么
工作原理同汽车、皮球、橡皮船充气	什么
外文名automobile tire inflator pump	什么
输入电源12v-15a	多少
优点抗穿刺，安全	什么
别名低压胎	什么
含义无内胎的充气轮胎	什么
构成电气设备	什么
定义对出现故障的汽车通过技术手段排查，找出故障原因，并采取一定措施使其排除故障并恢复达到一定的性能和安全标准	什么
种类汽车大修	什么
种类汽车小修	什么
定义修理或更换汽车任何零部件（包括基础件）的方法	什么
定义更换或修理个别零件的方法	什么
定义汽车不能完成其功能的现象	什么
种类发动机故障	什么
种类传动系故障	什么
种类转向系故障	什么
种类制动系故障	什么
种类行走系故障	什么
种类电气系统故障	什么
类别汽车故障	什么
类别发动机故障	什么
产生原因一是高压电路有问题,二是低压电路有问题,三是点火正时失调	为什么
处理方式检查分电器、火花塞、高压线等是否因为汽车淋雨等受潮，其次检查火花塞是否损坏，第三，检查蓄电池电压是否足够	怎样
产生原因车辆使用一段时间后，一些橡胶密封件老化，机油就会从密封件中泄漏，滴在排气歧管上，随着排气歧管温度升高，机油在短时间内蒸发，就会发出油烧焦的气味	为什么
处理方式更换密封件	怎样
产生原因怠速过低或化油器被堵塞	为什么
处理方式首先看怠速是否过低，如果怠速不稳或怠速低，只要把怠速调整到正常转速即可。还要把怠速截止阀拧紧，插头插紧。其次，如果怠速正常，则可能是化油器被堵塞，需要到专业修理站清洗化油器。	怎样
种类排气管冒黑烟	什么
种类排气管冒白烟	什么
种类排气管冒青烟	什么
类别排气管冒烟异常	什么
产生原因混合气过浓，与供油、配气、机械或电控系统的缺陷有关	为什么
处理方式检查火花塞和化油器	怎样
产生原因燃油中水分过高	为什么
处理方式查看汽车说明书，严格依照厂家规定添加标号正确的汽油	怎样
处理方式检查发动机缸体、汽缸垫是否有损伤，检查油箱内是否有积水	怎样
产生原因有烧机油现象	为什么
处理方式检查机油消耗情况	怎样
产生原因发动机曲柄连杆机构、配气系统相关零件过度磨损或油封失效引起的烧机油或漏油所致	为什么
处理方式检测机油是否泄漏	怎样
产生原因一般原因是滤清器堵塞进气不畅，冷却温度过高或过低，点火正时、配气相位或怠速调整不正确，发动机及主要零件磨损失效，气缸压力过低，油、气路管道及接头破漏，电控系统各传感器、接头及线路故障或ecu及连接器故障。	为什么
处理方式检查滤清器和火花塞	怎样
种类离合器故障	什么
种类手动变速器故障	什么
种类传动轴故障	什么
种类驱动桥故障	什么
类别传动系故障	什么
种类离合器打滑	什么
种类离合器异响	什么
种类离合器分离不彻底	什么
类别离合器故障	什么
产生原因由于离合器压紧力降低或摩擦面摩擦系数降低所致	为什么
表现现象在离合器踏板完全放松时，汽车起步或重载上坡乏力，汽车加速时车速不能随之提高，严重时离合器处出现冒烟和烧焦味	怎样
处理方式检查踏板自由行程、查看离合器摩擦片的边缘是否有油污甩出	怎样
表现现象在离合器接合或分离过程中以及转速或车速变化时离合器发出异响	什么
产生原因由于调整不当、润滑不良、机件不正常摩擦或碰撞	为什么
表现现象将离合器踏板踏到底仍感到挂档困难，挂上档后不抬离合器踏板汽车就前冲或者熄火	怎样
产生原因由于离合器调整不当、压盘或从动盘变形、离合器操纵油路中气阻影响离合器的完全分离所致	为什么
类别手动变速器故障	什么
表现现象变速器换档时很难挂上档位，勉强挂入后又很难回到空档	怎样
主要原因变速操纵机构的各运动件磨损、变形、润滑不良造成换档阻力，不能自如滑动	为什么
处理方式更换变形的拔叉；检查同步器定位弹簧、花键毂外齿是否有卡滞变形现象，如有则更换；更换连接部件；检查离合器踏板自由行程和离合器本身	怎样
表现现象汽车在某一档位行驶时，变速杆自动跳回空档位置，使动力传递中断的现象	什么
产生原因主要是运动件过度磨损或变形失效，造成啮合不正确，自锁失控，档位不能固定，发生跳档	为什么
处理方式先确定跳档档位，挂入跳档档位，发动机熄火，观察跳档齿轮的啮合情况	怎样
表现现象汽车起步挂档或行驶中换档，变速器挂入错误的档位，或是能挂入所需档位，但不能退回空档或一次挂入两个档位	什么
产生原因主要是变速机构机件磨损过度或损坏，无法正常工作所致。	为什么
处理方式摇动变速杆，检查其摆转角度	怎样
种类传动轴异响	什么
种类传动轴振动	什么
种类驱动桥异响和发热、驱动桥漏油	什么
种类转向跑偏	什么
种类转向车轮摇摆或方向盘摆振	什么
种类转向沉重	什么
种类液压转向助力有异响	什么
种类转向时油泵发出噪声或不起作用	什么
类别转向系故障	什么
表现现象直线行驶时，转向轮自动转向一侧使汽车跑偏	什么
产生原因左右汽车两轮行驶阻力不同，或动力转向系统有偏向一侧助力的趋势	为什么
表现现象汽车在行驶时，出现方向不稳来回摆头或方向盘发抖的现象	什么
产生原因由于转向车轮偏摆大，转向车轮动不平衡，转向机构机件松旷、前轮定位失准、动力转向液压系统进气等	为什么
表现现象车转向时，转动方向猛感觉沉重费力，且转弯后又不能及时回正方向。	什么
产生原因转向器与转向联动机构技术状态不佳，或前轮定位不正确，或轮胎和悬架存在故障，或是液压转向助力系统失效	为什么
产生原因多为齿轮啮合间隙过大	为什么
产生原因可能是油箱液面过低，液压系统渗入空气，液压回路或滤网堵塞，接头松动，油管破裂，油泵损坏等原因	为什么
种类制动失效	什么
种类制动效果不佳	什么
种类制动拖滞	什么
种类制动侧滑或跑偏	什么
种类驻车制动不良	什么
种类制动系统有异响	什么
种类防抱死制动系统故障灯亮	什么
表现现象行驶中使用制动时，汽车不能减速或停车；一次或多次连续制动后，制动突然不起作用	什么
产生原因可能是制动管路漏油或漏气，管路接头破裂或脱落，制动密封元件失效等	为什么
类别制动系故障	什么
表现现象需要制动时感觉到制动力明显不足，紧急制动时制动距离和制动时间明显增大	什么
产生原因制动密封元件密封不严或者制动缸活塞与缸壁配合松旷，制动油路中混有气泡，制动元件接触不良或者制动摩擦片油污等	为什么
表现现象制动踏板抬起后仍有制动作用，造成汽车起步困难，行驶无力，制动鼓发热，滑行距离缩短	什么
产生原因制动元件间隙过小，回位弹性元件失效使制动蹄不能回位，制动操纵机构配合部位锈蚀使回位困难等	为什么
表现现象制动时汽车向一侧偏驶的现象	什么
产生原因可能是两侧制动元件间隙不等，一侧的制动摩擦片油污，一侧回位弹性元件失效使制动蹄不能回位，车架变形，前轴移位等	为什么
表现现象拉紧驻车制动器后汽车很容易起步，或在坡路上停车时发生溜车现象	什么
产生原因可能是调整不当，制动盘（鼓）表面不平，制动摩擦片磨损严重或油污等	为什么
产生原因制动摩擦片磨损严重或摩擦片破损，传动轴花键松旷或联结螺栓松动等	为什么
产生原因车轮转速传感器故障	为什么
产生原因液控单元工作不正常	为什么
产生原因abs电子控制单元工作不正常	为什么
处理方式abs系统的泄压、abs系统电脑的更换、车轮速度传感器的调整	怎样
种类前后桥及前后悬架异响	什么
种类汽车行驶跑偏	什么
种类转弯时车身过分倾斜	什么
种类汽车振摆	什么
种类轮胎异常磨损	什么
类别行走系故障	什么
产生原因前后桥及前后悬架的运动件过度磨损或损坏，轴承间隙过大或轴承损坏，紧固螺栓松动，减振器缺油或损坏	为什么
产生原因可能是前后悬架连结件变形或车架变形，前后桥和前后悬架连结位置发生变化，前轮定位失调，两侧车轮气压或磨损程度差别过大等	为什么
产生原因可能是悬架弹簧局部损坏，悬架连结部位松动，横向稳定杆损坏或连结部位松动等	为什么
产生原因可能是前轮定位不正确，前轮不平衡，两前轮气压或磨损程度不同，车架、前轴、转向节变形，轮毂轴承或制动调整不当或左右松紧度不一致等	为什么
表现现象轮胎表面的单侧或局部出现非均匀磨损	什么
产生原因气压不足或过高，前束或车轮外倾角过大或过小，车轮不平衡，轮胎长期未换位，轮毂轴承松旷，转向柱销或球头销过度磨损，使用驾驶不当等	为什么
种类蓄电池自行放电	什么
种类蓄电池电解液消耗过快	什么
种类起动机转动无力或无动作	什么
种类起动机空转	什么
种类仪表盘上各仪表工作不良	什么
类别电气系统故障	什么
表现现象蓄电池充足电后未经使用，电量逐渐减少	什么
产生原因蓄电池电极制作材料不纯、电解液不纯、存放温度过高，或是蓄电池长期放置不用，硫酸下沉，极板上下部产生电位差等	为什么
产生原因可能与外壳、封口胶开裂，充电电流过大，行驶道路颠簸等所导致的漏液、溢液有关	为什么
产生原因蓄电池亏电，电极极柱污染造成接触不良，电极极柱连接松动，相关导线断路、连接不良或连接错误，起动机元件失调或失效	为什么
表现现象接通起动开关，起动机空转，而发动机不转	什么
产生原因故障主要在起动机的操纵和控制部分，或是起动机的单向啮合器	为什么
产生原因组合仪表供电线路或搭铁线路断路，各传感器及线路损坏，各指示仪表表芯损坏	为什么
定义指用于汽车维修保养的各类设备	什么
种类检测分析设备	什么
种类养护清洗设备	什么
著名生产企业博世	谁
著名生产企业百斯巴特	谁
著名生产企业spx	谁
种类汽车解码器	什么
种类读码卡	什么
种类数据流分析	什么
种类专用电脑	什么
种类试验台	什么
种类检测线	什么
种类定位仪	什么
种类检测仪	什么
种类检漏仪	什么
种类检测台	什么
种类制动台	什么
种类分析仪	什么
种类内窥镜	什么
种类传感器	什么
种类示波器	什么
种类烟度计	什么
种类自动变速箱清洗换油机	什么
种类动力转向换油机	什么
种类黄油加注机	什么
种类冷媒回收加注机	什么
种类喷油嘴清洗检测设备	什么
种类抛光机	什么
种类打蜡机	什么
种类吸尘机	什么
种类吸水机	什么
定义主要指用于手工操作的各类维修工具	什么
种类扳手	什么
种类螺丝批	什么
种类组套	什么
种类工具车	什么
种类工具箱	什么
种类工作台	什么
种类烤漆房	什么
种类烤漆灯	什么
种类调漆房	什么
种类大梁校正	什么
种类地八卦	什么
种类喷枪	什么
定义构成汽车配件加工整体的各单元及服务于汽车配件加工的产品	什么
全名罗伯特·博世有限公司	什么
创立时间1886年	什么时候
经营精密机械	什么
经营电气工程	什么
类别零件供应商	什么
全球汽车零部件供应商排名第1名	多少
员工数275000	多少
董事长弗朗茨·费润巴赫	谁
中国子公司博世	什么
创立时间1999年	什么时候
经营底盘控制系统	什么
经营车身控制系统	什么
经营刹车系统	什么
经营多媒体系统	什么
经营安全控制系统	什么
地址苏州工业园区苏虹西路126号	哪里
领先技术底盘控制系统	什么
产品事业部汽车电子事业部	什么
产品事业部底盘控制事业部	什么
产品事业部汽车多媒体事业部	什么
产品事业部pa-atmo3事业部—设备制造事业部	什么
获得认证ts 16949体系	什么
年销售量超过1亿套abs系统	多少
推出电子稳定系统	什么
推出防抱死制动系统	什么
优点能够防止车辆侧滑	什么
优点增强车辆的稳定性	什么
外文名esp	什么
整合功能防抱死制动系统	什么
整合功能牵引力控制系统	什么
外文名tcs	什么
外文名traction control system	什么
工作原理使用引擎点火的时间、变速箱档位和供油系统来控制驱动轮打滑的情形	什么
地址长沙星沙经济技术开发区漓湘中路26号	哪里
经营汽车部件	什么
经营汽车电子设备系统	什么
经营摩托车电机	什么
经营电动自行车电机	什么
创立时间2004年	什么时候
主要产品发电机	什么
主要产品蒸发风机	什么
主要产品冷凝风机	什么
主要产品雨刮电机	什么
主要产品举窗电机	什么
主要产品座椅调节系统	什么
主要产品防抱死制动系统	什么
经营火花塞	什么
经营检测设备	什么
经营汽车刹车片	什么
创立时间1995年12月11日	什么时候
前身南京华德火花塞有限公司	什么
体系认证iso9001质量管理体系	什么
体系认证iso/ts16949体系	什么
体系认证iso14001体系	什么
获得荣誉上海大众"a"级供应商	什么
获得荣誉一汽大众"a"级供应商	什么
获得荣誉中国嘉陵"a"级供应商	什么
年销售量1.25亿只火花塞	多少
年销售量8千万件制动片	多少
年销售量25000套检测设备	多少
公司电话8625-88041403	多少
电子邮件jie.sun2@cn.bosch.com	什么
地址南京经济技术开发区东区润博路1号	哪里
主要产品火花塞、检测设备、汽车刹车片等	什么
地址上海浦东新区榕桥路555号	哪里
经营发动机管理系统	什么
经营变速箱控制系统	什么
地址无锡	哪里
经营内燃机	什么
经营混合动力乘用车	什么
经营商用车	什么
经营电动车	什么
地址中国上海浦东大道1号船舶大厦4楼	哪里
经营传动技术	什么
经营控制技术	什么
外文名zf friedrichshafen ag	什么
总部地点德国friedrichshafen市	哪里
领先技术汽车动力传动系统	什么
领先技术底盘技术	什么
经营传动系统	什么
经营底盘系统	什么
经营特殊变速箱	什么
类别全球三大变速箱厂商	什么
全球汽车零部件供应商排名2017年第2名	多少
全球汽车零部件供应商排名2016年第5名	多少
年销售额7775百万欧元	多少
主要产品自动变速器	什么
主要产品手动变速器	什么
主要产品双离合变速器	什么
主要产品传动系统模块	什么
年销售额2018年7876百万欧元	多少
主要产品底盘系统	什么
主要产品底盘零部件	什么
主要产品悬架技术	什么
年销售额2018年3720百万欧元	多少
年销售额2018年2782百万欧元	多少
年销售额2018年2195百万欧元	多少
2018年销售额12121百万欧元	多少
主要产品基础制动	什么
主要产品制动控制单元	什么
主要产品齿条式电动助力转向系统	什么
主要产品管柱式电动助力转向系统	什么
主要产品安全气囊	什么
主要产品安全带系统	什么
主要产品方向盘系统	什么
中国子公司采埃孚股份公司	什么
经营自动变速器	什么
地址上海市嘉定区汇旺路649号	哪里
创立时间2017年	什么时候
地址浙江省嘉兴市经济技术开发区桐乡大道2929号	哪里
经营变速箱	什么
经营缓速器	什么
经营乘用车双质量飞轮	什么
经营电驱系统下的自动式手动变速器	什么
经营线控离合器	什么
创立时间2014年	什么时候
地址上海市青浦区华志路1139号	哪里
地址吉林省长春市东南湖大路5000号	哪里
创立时间2003年	什么时候
经营前后桥系统	什么
经营生产控制臂	什么
经营稳定杆连接杆	什么
经营差速器壳体	什么
地址沈阳经济技术开发区开发大路8甲3号	哪里
经营底盘	什么
经营前后桥	什么
经营汽车变速器换档系统	什么
经营汽车电子装置	什么
经营点火开关	什么
投资总额1600万欧元	多少
注册资本850万欧元	多少
主要产品汽车底盘，前后轿、发动机等零件	什么
公司电话024-85904665	多少
电子邮件jihong.zh@163.com	多少
创立时间1995年	什么时候
地址上海市奉贤区环城北路1088号	哪里
经营转向横拉杆	什么
经营控制臂	什么
经营球铰链	什么
经营稳定连接杆	什么
经营转向节	什么
经营后桥转向节	什么
地址上海市莘庄工业区申旺路280号	哪里
经营减振器	什么
经营麦弗逊支柱	什么
经营悬架	什么
地址浙江省杭州市萧山经济技术开发区桥南区春晖路9号	哪里
创立时间2005年	什么时候
经营变速器	什么
经营车桥	什么
经营转向系统	什么
经营乘用车车桥驱动	什么
经营新能源汽车驱动系统	什么
地址北京市经济技术开发区泰河一街2号	哪里
创立时间2015年	什么时候
经营风能技术	什么
经营高铁传动系统	什么
经营非公路车辆传动系统	什么
经营测试系统	什么
经营工业齿轮箱	什么
地址上海市嘉定区安亭镇百安路188号	哪里
创立时间2002年	什么时候
经营底盘电子动力液压转向系统	什么
经营防抱死制动系统	什么
经营安全气囊的安全电子控制模块	什么
经营驾驶员辅助电子系统	什么
地址广东省珠海市珠海大道东段北侧南屏科技工业园绿园路1号	哪里
经营汽车开关	什么
经营汽车传感器	什么
别名曼格纳	什么
别名玛格纳	什么
别名迈纳	什么
外文名magna international inc.	什么
国别加拿大	什么
总部地点加拿大安大略省	哪里
主要产品车身	什么
主要产品底盘	什么
主要产品外饰	什么
主要产品座椅	什么
主要产品动力总成	什么
主要产品主动驾驶辅助	什么
主要产品镜像	什么
主要产品闭锁及车顶系统	什么
全球汽车零部件供应商排名2017年第3名	多少
全球汽车零部件供应商排名2016年第3名	多少
中国子公司麦格纳	什么
地址江苏省昆山开发区出口加工区a区第三大道8号	哪里
注册资本640万美元	多少
经营车门窗	什么
经营门泵	什么
经营汽车闭锁	什么
经营汽车内饰系统	什么
登记机关昆山市市场监督管理局	谁
公司电话0512-57332737	多少
主要产品车镜系统，电子系统，塑料车身，车灯外饰系统，动力和驱动系统的配件	什么
创立时间2005年02月23日	什么时候
地址常州市新北区环保产业园环保一路6号4号	哪里
经营汽车变速箱	什么
经营燃油泵	什么
经营发动机部件	什么
经营铸锻毛坯件	什么
经营汽车传动系统零部件	什么
领先技术汽车车镜	什么
主要客户一汽大众	谁
主要客户上海大众	谁
主要客户上海通用	谁
主要客户武汉神龙	谁
主要客户天津丰田	谁
主要客户长安福特	谁
主要客户广州风神	谁
主要客户沈阳中华	谁
创立时间2007年2月15日	什么时候
经营电子稳定系统	什么
经营驱动系统	什么
经营存储系统	什么
经营燃料箱系统	什么
地址上海市嘉定工业区汇源路55号c幢	哪里
注册资本610万美元	多少
创立时间2005年9月13日	什么时候
经营驱动桥总成	什么
经营车身	什么
地址上海市嘉定区安亭镇百安公路1501号	哪里
主要客户南京福特马自达	谁
主要客户一汽奥迪	谁
主要客户北京奔驰	谁
排名日本第一	多少
全名日本株式会社电装	什么
外文名denso	什么
经营etc系统	什么
经营冷热箱	什么
经营自动空调	什么
经营发动机控制系统	什么
总部地点日本爱知县刈谷市昭和街	哪里
全球汽车零部件供应商排名2017年第4名	多少
全球汽车零部件供应商排名2016年第2名	多少
中国子公司电装	什么
创立时间1994年	什么时候
领先技术空调系统	什么
经营轿车	什么
经营水箱	什么
主要客户本田	谁
主要客户卡特彼勒	谁
主要客户小松	谁
主要客户三一	谁
体系认证iso14001环境管理体系	什么
体系认证ts16949质量管理体系	什么
体系认证ohsas18000职业健康与安全管理体系	什么
领先技术动力传动技术	什么
经营引擎ecu产品	什么
经营汽车组合仪表	什么
经营主车体ecu	什么
经营a/c ecu	什么
经营a/c panel	什么
经营继电器	什么
经营门控ecu	什么
经营安全气囊	什么
经营keyless受信机	什么
经营车载导航系统	什么
经营高压线	什么
经营橡胶件	什么
经营电容	什么
经营减震器	什么
主要产品橡胶件，高压线，电容，减震器等	什么
地址河北沧州市	哪里
经营理念顾客第一	什么
公司电话0317-2691583	多少
电子邮件jdqc2013@126.com	多少
创立时间1996年	什么时候
地址广州市金贵四街1-5号	哪里
经营分电器	什么
隶属澳门华信汽车贸易集团公司	什么
主要产品欧、美、日、韩等车系的配件	什么
公司电话020-87048399	多少
经营理念打造一级的汽车配件企业	什么
电子邮件hqqp168@163.com	多少
经营喷油器	什么
主要产品涡轮增压器、油泵、喷油器、发动机等配件	什么
公司电话0513-85997011	多少
电子邮件jinanhu001@163.com	多少
地址张庄路千宝汽配城	哪里
经营理念以一手的货源、直销的价格、健全的物流配送为广大客户提供优质的专业的服务	什么
外文名generators	什么
类别电工机械	什么
构成发电机	什么
外文名generator set	什么
工作原理缩小电机度迅速升高，达到燃点	什么
用途做功发电	什么
定义一分钟内所能完成的最大转数	什么
外文名rotationl speed	什么
计算公式n=60f/p	怎样
外文名generator reverse power	什么
别名功率方向保护	什么
环境空气温度50℃	多少
类别发电机	什么
特点工作转速高	什么
特点减小了重量和体积	什么
种类交流发电机	什么
种类直流发电机	什么
类别变频发电机	什么
主用功率200kw	多少
外形尺寸3.8*1.4*2.1(m)	多少
重量3.84(t)	多少
原则通用化	什么
原则标准化	什么
原则按系列化	什么
原料柴油	什么
类别发电机组	什么
定义190柴油发电机组由原中国石油部下属的大型股票上市公司济南柴油机股份有限公司生产	什么
功率范围500-2400kw	多少
所属公司丹麦avl公司	什么
特点低油耗	什么
特点成熟耐久	什么
特点性能稳定	什么
注意使用中应检查喷油提前角	什么
作用发电	什么
随机频率波动负载从0-100%	多少
功率范围10--30kw	多少
品牌宇动牌柴油发电机	什么
驱动方式柴油机驱动发电机	什么
品质因数10~40	多少
工作电源380v±15%/50hz	多少
最大试验容量3000kva及其以下	多少
直流0~60kv及以下	多少
谐振电压波形纯正弦波	什么
谐振电压波形波形畸变率≤1%	多少
输出频率50hz	多少
额定输出电压0~60kv（有效值）及以下（交流）	多少
定义自动控制和安全保护模块	什么
显示采用lcd	什么
特点采用微处理器为核心等	什么
lcd显示128×64点阵	什么
功能多语言菜单选择	什么
充电失败电压小于3v	多少
工作电压dc8.0v至35.0v连续供电	多少
超速频率额定频率的114%	多少
工作状态3种	多少
特点屏幕为lcd图标符号显示	什么
性质发电机组自起动模块	什么
外文名hgm170 generator controller	什么
工作状态3	怎样
性质自起动模块	什么
外形尺寸130mm x 112mm x 39mm	多少
整机功耗<3w(待机方式：≤2w)	多少
代号hgm6010k/6010kc	多少
外文名hgm6000k generator controller	什么
集成技术数字化	什么
集成技术智能化	什么
集成技术网络化技术	什么
供电电源范围(8－35)vdc	多少
屏幕液晶显示大屏幕lcd	什么
屏幕带背光	什么
核心技术微处理器技术	什么
集成技术智能化文可选界面操作，操作简单，运行可靠。	什么
燃油位fl单位%	什么
电压vb单位v	什么
转速spd单位rpm	什么
优点操作简单	什么
优点运行可靠	什么
外文名hgm6200k generator controller	什么
整机功耗<3w（待机方式：≤2w）	多少
三相电流ib	多少
三相电流ic	多少
三相电流ia	多少
三相线电压uca	多少
三相线电压ubc	多少
三相线电压uab	多少
频率f1	多少
特点液操作简单	什么
特点运行可靠	什么
输出端口两个	多少
性能能适应不同的起动电池电压环境	什么
特点可提供充电发电机励磁功能等	什么
规格直流电源：(8~35)v	多少
工作状态面板上轻触按钮人工起动等	怎样
特点水温/缸温高	什么
特点油压低	什么
性能能适应12v或24v起动电池环境	什么
简介为一个发电机组自起动模块	什么
工作状态面板上轻触按钮人工起动发电机组	怎样
功能数据测量	什么
功能报警	什么
功能自动开机/停机	什么
交流频率60hz	多少
交流频率50hz	多少
交流频率400hz	多少
整机功耗<6.6w(待机方式：≤4.6w)启动电流	多少
分辨率最小0.1mω	多少
测试电压2.5kv	多少
测试范围5mω～10000mω	多少
特点操作方便	什么
用途用于各种类型发电机组的保护	什么
采用技术现代微处理器控制技术	什么
外形尺寸88mm x 76mm x 44mm	多少
重量0.16kg	多少
准确度±5%	多少
测量范围0.1m～100gω	多少
试验电压2500v	多少
优点专用于水内冷化电势对测量结果的影响的功能，从根本上克服了其他同类产品的缺陷	什么
测量范围0.1m～1tω	多少
用途水内冷发电机的测量试验	什么
接线方式3相4线	怎样
频率50hz	多少
额定功率因数0.8	多少
额定电压400/230v	多少
优点数字控制	什么
优点高稳定性	什么
优点低耗油量	什么
技术特点低燃油消耗率和低排放技术	什么
产地日本	哪里
品牌三菱	什么
工作原理控制多台柴油发电机并车运行	什么
特点成本低	什么
特点寿命长	什么
种类手动	什么
种类自动	什么
种类全自动型	什么
定义是以上海柴油机股份有限公司生产的“东风”牌柴油发动机为动力，配置国内外著名发电机组装而成	什么
特点龙门式机体	什么
特点整体式曲轴	什么
优点优良的动力性	什么
优点稳定性	什么
优点经济性	什么
特点提高喷油压力	什么
特点改善燃烧过程	什么
特点高质量	什么
特点高性能	什么
适用范围工业	什么
外文名frequency generator	什么
输入频率50hz	多少
输出电压三相ac 26v--800v	多少
品牌泰山新动力	什么
特点电机寿命长	什么
特点免维护	什么
特点可靠性高	什么
功能折叠收纳功能	什么
优点便于携带	什么
结构收纳箱及发电系统	怎样
外文名bi-fuel generator sets	什么
优点机组功率基本不降	什么
使用燃料柴油和天然气的混合物	什么
优点控制无功功率	什么
外文名double-fed induction generator	什么
外文名dfig	什么
类别绕线式感应发电机	什么
性质有限公司	什么
地点上海	哪里
经营美国康明斯发电机	什么
经营英国劳斯莱斯发电机	什么
主要产品柴油发电机组	什么
经营百发电机独家销售服务	什么
专业陆用及铁路用发电设备	什么
固定资产5.5亿元	多少
地点东莞	哪里
创立时间2008年	什么时候
经营电机	什么
地点广西	哪里
创立时间2009年	什么时候
经营自动化柴油发电机组	什么
经营玉柴12kw-1200kw的普通型柴油发电机组	什么
类别基础机械	什么
作用支承转动部件，减少摩擦分	什么
种类滑动轴承	什么
种类滚动轴承	什么
类别轴承	什么
适用范围冶金	什么
适用范围风电	什么
适用范围矿山机械	什么
适用范围航天	什么
内径8mm	多少
厚度7mm	多少
品牌nsk	什么
类别调心球轴承	什么
外径22mm	多少
动载荷(cr)2750	多少
静载荷(cor)600	多少
适用范围用于电梯、升降、停车设备、调节阀、测试仪、风机、电焊、切割设备、炒药机、导柱、导套、硬度计、剥线钳、车用灯类等设备	什么
重量0.04kg	多少
规格尺寸12mm x 32mm x 10mm	多少
适用范围水泵	什么
适用范围机械压力机	什么
适用范围电渗析设备	什么
动载荷(cr)8000	多少
重量0.07kg	多少
静载荷(cor)2010	多少
内径17mm	多少
厚度12mm	多少
外径40mm	多少
动载荷(cr)12200N	多少
品牌fag	什么
代号1208-k-tvh-c3	什么
类别自调心球轴承	什么
代号1208-tvh	什么
内径55mm	多少
厚度21mm	多少
外径100mm	多少
重量0.71kg	多少
适用范围滴定仪	什么
适用范围汽车试验设备	什么
适用范围轮胎挖掘机	什么
适用范围磁力泵	什么
内径25.400mm	多少
类别单列圆锥滚子轴承	什么
新代号16016	多少
旧代号700116	多少
品牌koyo	什么
内径35.000mm	多少
代号19138x/19283x	多少
代号2002	多少
类别推力深沟球轴承	什么
代号2006	什么
代号208-npp-b	什么
类别外球面球轴承	什么
接触角60o	多少
极限转速6000r/min	多少
类别调心滚子轴承	什么
型号21304cc/w33	多少
内径20mm	多少
外径52mm	多少
极限转速4500r/min	多少
润滑脂填充量3.0cc	多少
品牌lhz	什么
代号30303/7303e	什么
系列圆锥滚子公制30000系列	什么
品牌fute	什么
代号30304	什么
代号30305/7305e	什么
代号30306/7306e	什么
品牌nachi	什么
代号5304	什么
类别角接触球轴承	什么
内径80.962mm	多少
外径139.992mm	多少
类别双外圈圆锥滚子轴承	什么
内径47.625mm	多少
代号59188/59412轴承	多少
外文名deep groove ball bearing	什么
密封形式开式	怎样
动载荷(cr)4550n	多少
静载荷(cor)1970n	多少
材质陶瓷	什么
材质碳钢	什么
材质轴承钢	什么
材质不锈钢	什么
适用范围建材机械领域	什么
倒角0.4	多少
宽度9mm	多少
新代号6002zz	多少
老代号102	多少
内径15mm	多少
外径28mm	多少
内径35mm	多少
外径55mm	多少
类别精密主轴轴承	什么
内径10mm	多少
外径26mm	多少
型号b7000c.t.p4s.ul	什么
内径10mm	多少
厚度8mm	多少
外径26mm	多少
内径12mm	多少
新型号7001c.t.p4s.ul	什么
品牌barden	什么
型号7024c/df	多少
内径150mm	多少
外径225mm	多少
外文名gear	什么
发明时间19世纪末	什么时候
适用范围加工制造	什么
定义对可用于加工制造齿轮的钢材的统称	什么
性能指标淬透性	什么
特点强度好	什么
特点硬度好	什么
特点韧性好	什么
类别齿轮钢	什么
执行标准en 10084-1998	什么
碳含量0.14～0.19	多少
锰含量1.00～1.30	多少
执行标准gb/t3077—1999	什么
硬度≤217hb	多少
统一数字代号a26202	什么
标准gb/t 3077-1999	什么
牌号20crmnti	多少
特性性能良好的渗碳钢等	什么
伸长率7.9(%)	多少
屈服强度1213mpa	多少
抗拉强度1587mpa	多少
别名正排量装置	什么
外文名gear pump	什么
应用学科液压传动	什么
应用学科机械工程	什么
应用学科传动	什么
适用范围机械制造	什么
类别齿轮泵	什么
作用输送润滑油	什么
旋转方向逆时针	怎样
适用范围各种机械设备	什么
类别轮油泵	什么
应用机床低压液压传动系统	什么
特点输油平稳	什么
特点噪声低	什么
工作原理将机械能转换为液压能	什么
类别低压泵	什么
特点维护方便	什么
特点工作可靠	什么
流量2.5-125l/min	多少
适用范围纺织机械	什么
适用范围液压系统	什么
优点耐酸碱	什么
优点耐磨损	什么
优点耐高温	什么
用途化工	什么
用途铸造机械	什么
用途制药	什么
类别化工泵	什么
功率0.12-1.1kw	多少
压力2.5mpa	多少
流量0.04-50l/min	多少
材质钢铁	什么
温度环境不高于80℃	多少
适用范围纤维的物体	什么
适用范围输送不含固体颗粒	什么
适用范围石油	什么
适用范围化工	什么
适用范围矿山	什么
安装位置挤出机出口与机头	哪里
设计容积式设计	怎样
用途高温高粘度聚合物熔体的输送	什么
定义液压泵、液压马达、液压缸、液压阀、增压器等一切用于液压系统的元件	什么
类别液压件	什么
驱动方式电动机	怎样
结构齿轮泵、柱塞泵、叶片泵和螺杆泵性	怎样
功能把动力机（如电动机和内燃机等）的机械能转换成液体的压力能	什么
别名油马达	什么
外文名hydraulic motor	什么
类别液压马达	什么
优点结构简单紧凑	什么
优点起动特性好	什么
寿命长	多少
效率高	多少
作用减少了热量产生	什么
特点密封性好	什么
适用范围轻工机械	什么
适用范围塑料机械	什么
中文名鎌田枫子	什么
推荐用油抗磨液压油,粘度37~73cs	什么
特点启动压力低,效率高,低速运转平稳	什么
结构型式标准马达，车轮马达	怎样
特点工作压力高	什么
特点工作效率高	什么
技术采用先进的镶柱式定转子参数设计	什么
外文名hydraulic cylinder	什么
特点只能由活塞的一侧输入压力油	什么
作用产生推力	什么
类别液压缸	什么
定义活塞的一侧有活塞杆的液压缸	什么
构成单杆液压缸	什么
定义活塞的两侧都有活塞杆的液压缸	什么
特点实现等速往复运动	什么
结构缸筒和缸盖等	怎样
驱动方式双向液压驱动	怎样
回转间隙10dm	多少
最高扭矩250,000nm	多少
标准工作压力21mpa	多少
年营业额200000	多少
总部地点盐城市	哪里
创立时间2003	什么时候
经营液压件	什么
公司性质有限公司	什么
总部地点邯郸市	哪里
公司性质民营企业	什么
员工数2000余人	多少
创立时间1965年	什么时候
经营专业制造液压缸的国家高新技术企业	什么
资产2亿元	多少
定义广义的电线电缆亦简称为电缆，狭义的电缆是指绝缘电缆	什么
导电性导体	怎样
用途传输电（磁）能	什么
用途单芯软导体无护套电缆	什么
温度环境70℃	多少
外文名60227iec02(rv)	多少
导电性第五种铜导体	什么
执行标准gb/t5023.3-2008	多少
额定电压450/750v	多少
执行标准gb12706.3-91	多少
温度环境90℃	多少
铺设环境敷设在室内	哪里
特点发生火灾保持电路的完整性	什么
用途建筑物内的火灾警报系统	什么
类别电线电缆	什么
额定电压300/500v	多少
定义180℃及以上的温度下能正常工作	什么
用途增加截流能力	什么
用途高温下能够正常传输信号或电能	什么
硬度85a到95a之间	多少
超软规格70a	多少
超软规格60a	多少
超软规格80a	多少
温度环境130℃以上	多少
创立陶成才博士于2010年	什么时候
引进美国okonite cable	什么
公司公司	什么
主营业务特种电缆的研发和生产任务	什么
经营拖链电缆	什么
经营trvv/trvvp电缆	什么
类别仪器	什么
燃烧气体纯度超过95%的丙烷	什么
电线电缆长度（600±25）mm	多少
金属罩宽（1200±25）mm	多少
用途火焰条件下单根绝缘电线	什么
长度（600±25）mm	多少
宽度（1200±25）mm	多少
深度（450±25）mm	多少
高度（300±25）mm	多少
产品标准tl/j19---92（等效vde0250)	什么
主要产品ntscgecrwou	什么
最大外径68mm	多少
工作原理马达传动	什么
容量0-2t	多少
用途金属	什么
用途五金	什么
外观采用铝合金防护罩	怎样
有效拉伸空间800mm	多少
荷重元精度0.01%	多少
操作操作简单	多少
特点自动控制	什么
用途金属测试	什么
优点使各个螺旋盘条的位置得到正确的定位，因此最大限度地减少网带的变型和延伸。	什么
特点具有弯曲较深的串条	什么
材质1cr13耐热钢	什么
材质45#钢	什么
安装位置安装在曲轴和缸体的固定托架上	哪里
定义起到轴承作用的瓦片	什么
极限磨损量不超过0.17mm	多少
表面粗糙度(ra)0.8μm	多少
长度高出轴瓦座平面0.03-0.05mm	多少
用途承接连杆的上下运动变成循环运动	什么
特点噪音低	什么
结构五柱塞结构	怎样
适用范围发动机	什么
用途减小曲轴的振动	什么
类别减震器	什么
用途测试疲劳程度	什么
特点找到共振频率	什么
意义发动机最重要的机件	什么
材质中碳钢或中碳合金钢	什么
作用提高耐磨性和耐疲劳强度	什么
特点刚性足	什么
砂轮分辨率0.005mm	多少
适用领域用于汽车拖拉机和柴油机制造厂	什么
定义按加工要求预先编制程序，由控制系统发出数值信息指令,对曲轴的曲柄颈、主轴颈、连杆颈、止推面进行加工的磨床	什么
圆度0.003mm/0.005mm	多少
端面粗糙度 0.63μm	多少
纵截面直径0.004mm/0.006mm	多少
刀架纵向行程250mm	多少
主轴转速50-300r/min	多少
长度1200mm	多少
类别螺母	什么
外文名120° small countersunk head riveted nuts	什么
实施日期2000-5-1	什么时候
标准号gb/t 17880.4-1999	什么
发布日期2000-9-26	什么时候
外文名prevailing torque type all-metal hexagon nuts	什么
标准号gb/t 6184-2000	什么
代替国标号gb 57-1976,gb 58-1976	什么
发布日期1986-1-17	什么时候
外文名style 1--product grades a and b	什么
实施日期1986-10-1	什么时候
标准号gb/t 6178-1986	什么
标准号gb/t 6179-1986	什么
主管部门中国机械工业联合会	谁
代替国标号gb/t 6170-1986	什么
中国分类号j13	什么
国际分类号21.060.20	什么
国际标准号iso 4032:1999	什么
中国标准号gb/t 6170-2000	什么
外文名hexagon nuts	什么
外文名style 1	什么
实施日期2001-2-1	什么时候
归口单位全国紧固件标准化技术委员会	谁
标准状态现行	怎样
标准类别主要产品	什么
起草单位机械科学研究院	谁
采用程度eqv	怎样
外文名prevailing torque type hexagon nuts	什么
标准号gb/t 889.1-2000	什么
外文名prevailing torque type all-metal hexagon nuts style 2	什么
外文名style 2--property class 9 nuts	什么
标准号gb/t 6186-2000	什么
标准号gb/t 6180-1986	什么
外文名style 2-product grades a and b	什么
外文名hexagon nuts style 2	什么
标准号gb/t 6175-2000	什么
发布日期2011-1-10	什么时候
实施日期2011-10-1	什么时候
标准号gb/t 6182-2010	什么
用途板材纵剪机用刀片轴向锁紧	什么
工作原理“t型手柄”来旋转“加压螺杆”	什么
特点质量稳定	什么
别名拉铆螺母	什么
适用领域汽车	什么
适用领域航空	什么
主管单位中国机械工业联合会	谁
发布日期2009-10-15	什么时候
标准号gb/t 802.4-2009	什么
发布日期1988-6-24	什么时候
外文名hexagon thick nuts	什么
标准号gb/t 56-1988	什么
外文名hexagon thin slotted nuts--product grades a and	什么
标准号gb/t 6181-1986	什么
标准号gb/t 802.3-2009	什么
特点铆接牢固效率高	什么
特点使用方便	什么
适用范围各类金属板材、管材等制造工业	什么
外文名acorn hexagon nuts	什么
标准号gb/t 923-2009	什么
优点板材背面保持完全嵌平	什么
优点采用易切削铁或易切削不锈钢	什么
定义压铆螺柱或螺母柱	什么
定义为快削钢通孔压铆螺母柱so型入板内使导致孔的的周边产生塑性变形，变形物被挤入导向槽，从而产生锁紧的效果。	什么
螺纹规格m8-m100*6	多少
型号gb825-m20	什么
适用范围起吊机械等的装卸	什么
功能供连接螺杆固定绝热层用的	什么
外文名fixing nut	什么
别名王八垫	什么
别名止退垫圈	什么
功能防止圆螺母松动的垫圈	什么
外文名small hexagon thin nuts--fine pitch thread	什么
标准号gb/t 808-1988	什么
外文名small round nuts	什么
标准号gb/t 810-1988	什么
发布日期1999-10-11	什么时候
外文名standardtitle in chinese	什么
国际标准号uni 9203:1988	什么
国内标准号gb/t 17880.3-1999	什么
外文名nylon locking nut	什么
温度环境-50～100℃	多少
别名塑料螺母	什么
外文名plastic nuts	什么
材料尼龙66（nylon66）	什么
外文名insert round nuts	什么
实施日期1989-7-1	什么时候
发布日期1988-6	什么时候
作用调节（托盘）天平重心	什么
外文名balance nut	什么
材料钢、铅等密度大的金属	什么
功能紧固件的二面与板保持平齐	什么
厚度可薄至11.5mm	多少
适用范围用于薄板	什么
作用提高疲劳强度	什么
特点纹副强度提高40%	什么
外文名broachlngnuts	什么
螺纹尺寸m2到m5	多少
适用范围安装于p.c板上	什么
制作工艺盘元-酸洗-冷拔-冷镦	怎样
适用领域机械	什么
材料swrch10k或swrch15k	什么
特点关键在于螺纹的结构形状	什么
方式销钉	怎样
方式变形螺纹	怎样
方式尼龙嵌入	怎样
缺点在剧烈震动中会自行松脱	什么
发布日期2000-10-17	什么时候
实施日期2001-5-1	什么时候
标准号gb/t 18230.3-2000	什么
别名锁紧螺母	什么
工作原理采用螺母和螺栓之间的摩擦力自锁	什么
别名铆螺母	什么
别名自扣紧螺母	什么
外形一端带有压花齿及导向槽	什么
适用范围薄板或钣金上	什么
种类嵌尼龙圈	什么
功能防松	什么
功能抗振	什么
工作原理靠摩擦力自锁	什么
发布日期2004-2-10	什么时候
外文名wing nuts--die-casting wing	什么
标准号gb/t 62.4-2004	什么
外文名wing nuts--round wing	什么
实施日期2004-8-1	什么时候
标准号gb/t 62.1-2004	什么
外文名wing nuts--square wing	什么
作用用来固定汽车轮胎的轮毂壳	什么
别名轮胎螺母	什么
材质a3低碳钢、35k高速钢线材	什么
螺纹规格螺距一般均为1.5mm和2.0mm	多少
适用范围日常生产活动	什么
材质铜	什么
用途注塑	什么
适用范围冶金、起重、工程运输、矿山、石油、船舶、煤炭、橡胶、造纸机械及其它重机行业	什么
特点运载平稳	什么
特点结构紧凑合理	什么
类别万向联轴器	什么
别名联轴器长伸缩焊接式十字轴式万向	什么
型号swc-ch	什么
特点能使不在同一轴线或轴线折角较大或轴向移动较大的两轴等角速连续回转，并可靠地传递转矩和运动	什么
特点具有较大的角度补偿能力	什么
用途用来联接不同机构中的两根轴	什么
适用范围轧机主传动和辅机传动	什么
两轴线夹角一般≤5°-45°之间	多少
结构型式球笼式	怎样
结构型式十字轴式	怎样
特点装拆维护方便	什么
特点承载能力大	什么
公称转矩tn kn.m 40	多少
疲劳转矩tf kn.m　16	多少
轴线折角β≤10°	多少
类别万向联轴器公称转矩16tn /n.m	什么
回转直径d160	多少
疲劳转矩8tf kn.m	多少
回转直径d/d0 200-285	多少
疲劳转矩tf kn.m 16	多少
轴线折角β≤ 10°	多少
公称转矩16～1250kn·m	多少
回转直径160～640mm	多少
适用范围轧制机械等	什么
两轴线夹角5°-45°之间	多少
作用减振和提高轴系动态性能	什么
作用缓冲	什么
材料45号钢等	多少
特点角向补偿量较大	什么
结构型式球叉式	怎样
适用范围重型机械	什么
适用范围冶金机械	什么
专利号zl 201120144863.8	多少
波动现象随轴间角增大而变剧烈	什么
用途用于高速传动	什么
特点采用滑动传动	什么
传动方式滑动	怎样
性质万向联轴器	什么
特点降低噪声	什么
外文名ratchet	什么
定义具有齿形表面或摩擦表面的轮子	什么
特点外廓较大	什么
类别啮合式超越离合器	什么
构成棘轮-棘爪式超越离合器	什么
外文名air ratchet wrench	什么
最大重量0.51kg	多少
棘爪数12	多少
污染等级3级	多少
海拔高度不超过2000m	多少
适用范围交流50hz电压至380伏的电路电动机的起动调速制动或换向	什么
安装类别iii类	什么
海拔高度不超过2000米	多少
优点紧凑	什么
优点结构简单	什么
优点设计方便	什么
外文名cam	什么
拼音tū lún	什么
缺点易磨损	什么
定义机械的回转或滑动件	什么
定义是一种高精度的回转装置	什么
别名间歇分割器	什么
别名凸轮分度器	什么
发明者福克森	什么
定义外圈壁特别厚的球轴承	什么
特点带有球定心的铆接钢保持架	什么
类别滚子	什么
应用领域石油化工	什么
应用领域精细化工	什么
行业机械制造	什么
使用部位气缸顶部	什么
外文名single overhead camshaft	什么
适用范围高速发动机	什么
结构密珠滚珠结构	什么
外文名double over head camshaft（dohc）	什么
应用轮轴技术	什么
类别凸轮轴	什么
定义为保证进排气效率，都采用进气门和排气门倒挂的形式，即顶置式气门装置。	什么
作用提高了传动效率	什么
形式中置、下置、顶置三种形式	怎样
定义利用构造的凸轮曲线来模拟机械凸轮，以达到机械凸轮系统相同的凸轮轴与主轴之间相对运动的软件系统。	什么
传感器旋变	什么
工作原理利用凸轮曲线来模拟机械凸轮	什么
外文名ecam	什么
分度曲面圆柱面	什么
分度曲面圆锥面	什么
分度曲面圆环面	什么
特点具有一个或几个螺旋齿	什么
定义具有一个或几个螺旋齿，并且与蜗轮啮合而包含交错轴齿轮副的齿轮	什么
种类阿基米德蜗杆、渐开线蜗杆、法向直廓蜗杆、锥面包络圆柱蜗杆	什么
定义指的是以蜗杆为主动作减速传动，当反行程不自锁时，也可以蜗轮为主动作增速传动	什么
特点结构紧凑	什么
特点传动比大	什么
构成蜗杆传动	什么
传动功率一般应在50kw以下，最大可达到1000kw左右	多少
齿面间相对滑动速度15m/s以下(最高可达35m/s)	多少
优点能耗低	什么
优点振动小	什么
优点噪音低	什么
常用型圆柱蜗杆减速机	什么
结构中空轴式	什么
特点坚固耐用	什么
特点传动平稳	什么
作用用来做切断	什么
工作原理靠旋转阀恋来使阀门畅通或闭塞	什么
特点密封可靠	什么
特点结构 简单	什么
主动件蜗杆	什么
适用范围转向力较大的载货汽车	什么
传动比7.5-100	多少
功率0.06kw～7.5kw	多少
转矩2.6n·m～2379n·m	多少
交错角90°	多少
构成锥蜗杆传动	什么
温度环境为-40到+40℃	多少
输入转速不超过1500r/min	多少
特点传动效率高	什么
蜗杆转速不超过1500r/min	多少
定义一种新型的传动装置	什么
标准号q/jf01-1999	什么
特点散热性能优良	什么
适用范围纺织	什么
适用范围皮革	什么
适用范围食品	什么
产品规格25-150	多少
输入功率0.06-15kw	多少
输出转矩2.6-2670nm	多少
类别二级减速传动机构	什么
特点无噪音	什么
特点工作平稳可靠	什么
功率0.12kw～22kw	多少
转矩10n·m～4890n·m	多少
输出转速0.12～397r/min	多少
类别活塞	什么
缺点晶粒粗大	什么
缺点铝液增铁	什么
直径190mm	多少
铸造方式低压铸造和挤压铸造	怎样
作用降低机械噪音	什么
作用避免咬轴现象	什么
基体钢板	什么
特点耐磨性能好	什么
特点抗腐蚀性好	什么
气压6kg	多少
灌装精度±1﹪以内	多少
灌装速度0-120瓶/分钟	多少
缺点不适应用于输送高热蒸气	什么
特点安装方便	什么
特点体积小	什么
公称压力(mpa)1.62.5	多少
壳体试验压力(mpa)*2.43.75	多少
密封试验压力(mpa)1.62.5	多少
替代连杆曲柄	什么
应用动力机械产品	什么
结构紧凑	怎样
结构结构轻巧	怎样
种类单作用、双作用和级差式	什么
工作原理通过活塞往复运动	什么
类别压缩机	什么
优点效率高	什么
优点体积小	什么
作用提供动力	什么
内表面圆柱形	怎样
特点复杂的气门控制机构	什么
公称压力1.0mpa	多少
材质铸钢	什么
材质铸铁	什么
作用将机械能转化成压力能	什么
种类单作用	什么
种类双作用	什么
外文名vane pump	什么
性质动力元件	什么
主要型号单联泵pvr1	什么
主要型号pvr2	什么
主要产品yuken柱塞泵	什么
主要产品yuken叶片泵	什么
特点高压高性能	什么
特点流量范围宽	什么
公司日本油研工业株式会社	什么
相关产品不二越nachi齿轮泵	什么
相关产品nachi叶片泵	什么
主要型号vds-0a	什么
主要型号vds-0b	什么
创始人kohki井村	谁
别名工作母机	什么
别名工作母机工具机	什么
含义指制造机器的机器	什么
外文名machine tool	什么
别名工件自动装卸装置	什么
外文名machine tool loading device	什么
通孔直径46.00mm	多少
鼻端规格a2-4	多少
外文名hvct	什么
动载荷(cr)3700N	多少
静载荷(cor)6290N	多少
最高工作转速6000r/min	多少
润滑方式油脂润滑	怎样
编码器带轮xl54t125as	多少
适应卡盘op-204/op-205	多少
驱动功率3.7kw	多少
类别机床	什么
外文名computer numerical control	什么
特点加工精度高	什么
构成cnc数控机床	什么
发明时间1911	什么时候
适用范围加工汽车零件	什么
对象法兰盘等中小异形零件	什么
工序中频感应加热及喷液淬火	怎样
类别感应热处理装置	什么
类别机器	什么
连接方式串联	怎样
优点工作范围大	什么
优点灵活性好	什么
别名虚拟轴机床	什么
缺点刚性差	什么
缺点精度低	什么
优点生产效率高	什么
优点气动自动上料	什么
作用批量销轴淬火	什么
对象盘类	什么
对象轴类	什么
对象销类	什么
技术数控技术	什么
特点分段连接	什么
分辨率≤3000dpi	多少
型号dmb-30-18	多少
型号dmb-30-25	多少
控制柜尺寸900*850*165mm	多少
别名多功能复合加工机床	什么
别名复合加工机床	什么
外文名complex machine tools	什么
别名泡沫数控机床	什么
性质数控设备	什么
用途汽车冲压模具泡沫型加工	什么
宽750mm	多少
长1000mm	多少
高750mm	多少
最大工件直径300mm	多少
最大工件重量5t	多少
最大工件长度4000mm	多少
优点快速	什么
优点灵活	什么
应用领域核能	什么
应用领域海洋开发	什么
应用领域航空	什么
应用领域航天	什么
发明时间1891	什么时候
种类卧式深孔钻镗床	什么
种类立式深孔钻镗床	什么
外文名deep hole machine	什么
特点输出平稳	什么
特点低频力矩大	什么
频率0—400hz	多少
类别书籍	什么
isbn9787302238539	多少
书名实用机床电气系统维修技术	什么
作者张云杰、陈锋正	谁
出版时间2010-10-01	什么时候
出版社清华大学出版社	什么
开本16开	多少
页数329页	多少
书号isbn 7-5084-0063-1/tm.2	多少
作者芮静康	谁
出版社中国水利水电出版社	什么
isbn9787111292463, 7111292464	多少
书名实用机床设计手册	什么
出版时间2010年4月1日	什么时候
出版社机械工业出版社	什么
装帧方式精装: 1441页	怎样
isbn9787534920196	多少
书名常用机床电气检修一点通	什么
作者陈海波	谁
出版时间2013年5月	什么时候
isbn9787504555762	多少
出版时间2006-5	什么时候
价格17.00元	多少
页数184	多少
isbn9787111431114	多少
书名常见机床电气控制线路的安装与调试	什么
作者黄立君	谁
出版时间2014年2月27日	什么时候
开本16	多少
语种简体中文	什么
页数178页	多少
isbn9787115230669	多少
书名数控机床操作与维护技术(第2版)	什么
作者周晓宏	谁
出版时间2010-11-1	什么时候
出版社人民邮电出版社	什么
价格29.80	多少
主体机床工具工业的制造企业	什么
外文名cmtba	什么
创立时间1988年3月	什么时候
类别组织机构	什么
从事切削刀具	什么
原名中国工具专业协会	什么
创立时间1987年7月	什么时候
组织人员数5000余人	多少
年销售额20亿元	多少
创立时间1988年	什么时候
对象机床工具	什么
创立时间1987年6月	什么时候
性质钻镗床	什么
创立时间1988年3月	什么时候
秘书长刘春时	谁
别名导轨软带	什么
别名贴塑导轨	什么
原料氟素树脂	什么
特点优异的摩擦磨损特性	什么
最大工件尺寸1050 x 820 x 305(mm)	多少
最大工件重量1500kg	多少
电极丝直径0.1~0.3mm	多少
最大工件尺寸700 x 550 x 215(mm)	多少
最大工件重量500kg	多少
电极丝直径0.1~0.3mm	多少
型号ea12dm	什么
类别成型放电加工机床	什么
型号ea12vm advance	什么
工件重量700kg	多少
电极重量50kg	多少
工件重量2000kg	多少
电极重量200kg	多少
行程x:650 y:450 z:350	多少
型号fa10ps advance	什么
类别线切割加工机床	什么
型号fa10s advance	什么
型号fa20ps advance	什么
最大工件尺寸1050 x 800 x 295mm	多少
最大工件重量1500kg	多少
电极丝直径0.1~0.3mm	多少
行程x:500 y:350 z:300	多少
创立品牌沪冲牌	什么
占地面积一万八仟多平方米	多少
总部地点上海宝山区陈广路1388号	哪里
宗旨立足于产品的质量管理	什么
总部地点上海	哪里
经营范围折弯机	什么
经营范围剪板机及刃模具	什么
创立时间2002年12月	什么时候
经营范围机床工具	什么
主要产品炮塔铣床	什么
主要产品电火花	什么
主要产品精密磨床	什么
宗旨质量第一	什么
宗旨诚信至上	什么
